切り|end, finish, place to stop
農場|farm (agriculture)
惑星|planet
尾|tail (of an animal), cauda
矢|arrow
地獄|hell realm, Naraka
津波|tsunami, tidal wave
皇居|Imperial Palace (of Japan), imperial residence
流通|circulation (of money, goods, etc.), distribution
仏像|statue of Buddha, image of Buddha, Buddhist statue, Buddhist image
見合い|(formal) meeting with a view to marriage, interview with a prospective spouse
水源|source of river, fountainhead
海運|maritime transport, shipping
黄金|gold (Au)
嬢|unmarried woman
振り|swing, shake, wave, swinging
死|death
説得|persuasion
助言|advice, counsel, suggestion, tip, hint
理論|theory
怒り|anger, rage, fury, wrath, indignation
秘書|(private) secretary
紳士|gentleman
証拠|evidence, proof
選挙|election
運命|fate, destiny, lot
世|world, society, public
天才|genius, prodigy, natural gift
富|riches, wealth, fortune
取引|transactions, dealings, business
階|storey, story, floor
危機|crisis, critical situation, emergency, pinch
勝利|victory, triumph, win, conquest, success
交渉|negotiations, bargaining, discussions, talks
予想|expectation, anticipation, prediction, forecast, conjecture
距離|distance, range, interval
政策|political measures, policy
幽霊|ghost, specter, spectre, apparition, phantom
洪水|flood, flooding
同情|sympathy, compassion, pity
航海|(sea) voyage, navigation, sailing, passage, cruise
破壊|destruction, disruption
自信|self-confidence, confidence (in oneself)
世代|generation
投資|investment
殺人|murder, homicide, manslaughter
治療|(medical) treatment, care, therapy, cure, remedy
小切手|cheque, check
反応|reaction, response
制服|uniform
企画|planning, plan, project, arrangements
報道|report (of news), reporting, news, information, (media) coverage
賃金|wages, pay
権力|(political) power, authority, influence
暴力|violence, mayhem
名誉|honor, honour, credit, glory, fame, distinction
貧困|poverty, penury, need, destitution
美|beauty
保険|insurance
妥協|compromise, giving in
聖書|Bible, the Scriptures, Holy Writ
孤独|solitude, loneliness, isolation
昆虫|insect, bug
牧師|pastor, minister, clergyman, reverend
向き|direction, orientation, aspect, exposure
判決|judicial decision, judgement, judgment, sentence, decree
保護|protection, safeguard, guardianship, custody, patronage
規制|regulation, (traffic) policing, control, restriction
倒産|(corporate) bankruptcy, insolvency, commercial failure, failed business
着陸|landing, alighting, touch down
偏見|prejudice, bias, distorted view
入浴|bathing, going in the bath
証言|testimony, (verbal) evidence
財政|public finance
報酬|remuneration, recompense, reward, toll
人民|the people, citizens, the populace
革命|revolution
決断|decision, determination
自己|self, oneself
動機|motive, incentive
予言|prediction, prophecy, prognostication, foretelling, forecast
祈り|prayer, supplication
暴動|insurrection, riot, uprising, rebellion, revolt
移民|immigration, emigration
改革|reform, reformation, reorganization
死刑|death penalty, capital punishment
爆弾|bomb
真珠|pearl
妊娠|pregnancy, conception, gestation
災害|calamity, disaster, misfortune
実業家|businessman, entrepreneur, captain of industry
承諾|consent, approval, acceptance, agreement, compliance
燃料|fuel
民族|people, race, nation, ethnic group, ethnos
人格|personality, character, individuality, personhood
権威|authority, power, influence, prestige
伝説|legend, folklore, tradition
網|net, netting
悪|evil, wickedness
定義|definition
認識|recognition, awareness, perception, understanding, knowledge, cognition, cognizance, cognisance
植民地|colony
圧力|pressure, stress
体力|stamina, endurance, physical strength, resilience, resistance to disease
品質|quality (of a product or a service)
孤児|orphan
反乱|insurrection, mutiny, rebellion, revolt, uprising
脳|brain
物体|object, body, solid
福祉|welfare, well-being, social welfare, social security, social service
海峡|channel (e.g. between two land masses), strait
宮殿|palace
芝|lawn, sod, turf
火星|Mars (planet)
探検|exploration, expedition
文書|document, writing, letter, papers, notes, records, archives
戦闘|battle, fight, combat
柱|pillar, post
真理|truth
正義|justice, right, righteousness
日焼け|sunburn, suntan, tan
条約|treaty, pact, convention, agreement
声明|declaration, statement, proclamation
職員|staff member, employee, worker, personnel
闇|darkness, the dark
出血|bleeding, haemorrhage, hemorrhage
関税|customs (duties), duty, tariff
内閣|cabinet (of a government), ministry
憎しみ|hatred
本能|instinct
思考|thought, consideration, thinking
形態|form, shape, figure
尿|urine
固定|fixing (in place), being fixed (in place), securing, anchoring, fastening down
見積もり|estimate, estimation, valuation, quotation
概念|general idea, concept, notion
視野|field of vision, view
良心|conscience
看護|nursing, (army) nurse
資産|property, fortune, means, assets
根源|root, source, origin, cause
転勤|job transfer, job relocation, intra-company transfer
面会|meeting (face-to-face), seeing, visit, interview
負債|debt, liabilities
恋愛|love, love-making, passion, emotion, affections
独占|monopoly, monopolization, exclusivity
疲労|fatigue, weariness, exhaustion, tiredness
電線|electric line, electric cable, power cable
貴族|nobility, aristocracy, peerage
在庫|stock, inventory
運賃|(passenger) fare
家出|running away from home, elopement
乱用|abuse, misuse, misappropriation, using to excess
権限|power, authority, jurisdiction
奉仕|service, ministry, attendance, church work
遺跡|(archeological) remains, ruins, relics
山脈|mountain range, mountain belt
扉|door, gate, opening
潮|tide, current
肺|lung
天国|paradise, heaven, Kingdom of Heaven
与党|ruling party, government party, party in power, government
固体|solid (body), solid matter, solid-state
救済|relief, aid, help, rescue
腐敗|decomposition, putrefaction, putrescence, spoilage
退学|dropping out of school, withdrawal from school
戦術|tactics
分裂|split, division, break up
統制|regulation, control
原子|atom
主食|staple food
野党|opposition party, the opposition
喜劇|comedy
人体|human body
実践|practice, putting into practice, implementation
収益|earnings, proceeds, returns, revenue
設定|establishment, creation, posing (a problem), setting (movie, novel, etc.), scene
得点|scoring, score, points made, marks obtained, goals, runs
人質|hostage
家畜|domestic animals, livestock, cattle
細胞|cell
主人公|protagonist, main character, hero, heroine
感染|infection, contagion, becoming infected
反発|opposition, rebellion, revolt, resistance, backlash, refusal
模型|model, dummy, maquette
占領|occupying, having (an area) all to oneself
暗殺|assassination
政権|(political) administration, political power
堤防|bank, weir, embankment, levee
証人|witness
脅迫|threat, menace, coercion, blackmail
抑圧|check, restraint, oppression, suppression
本質|essence, true nature, substance, reality
乱れる|to be disordered, to be disarranged, to be disarrayed, to be disheveled, to be dishevelled
回路|circuit (electric)
君主|monarch, sovereign, ruler, liege (lord)
貨幣|money, currency, coin
同調|conformity, alignment, agreement, sympathy, following suit
詐欺|fraud, swindle, graft, cheating, trick, scam
基金|fund, foundation
無効|invalid, void, ineffective, unavailable
清算|(financial) settlement, squaring accounts, clearing debts
天体|heavenly body, celestial body, astronomical object
中立|neutrality
襟|collar, lapel, neckband, neck
織物|textile, fabric
脂肪|fat, grease, blubber, lard, suet
刃|edge (of a knife or sword), blade
作戦|tactics, strategy
強制|compulsion, coercion, forcing (to do), enforcement
漁船|fishing boat
世帯|household, home, family, housekeeping
視覚|sense of sight, vision
枠|frame, framework
解除|termination (of a contract), cancellation, rescinding, rescission
照明|illumination, lighting
仕様|way, method, means, resource, remedy
利子|interest (on a deposit, loan, etc.)
調理|cooking, food preparation
墓地|cemetery, graveyard
戯曲|drama, play
前提|condition, assumption, prerequisite, hypothesis
官僚|bureaucrat, government official, bureaucracy
教員|teacher, instructor, teaching staff, faculty member
反射|reflection, reverberation
反響|echo, reverberation
映像|image (on a screen), picture (e.g. on a TV)
装飾|ornament, decoration
蜜|nectar
均衡|equilibrium, balance
僧|monk, priest
聴覚|the sense of hearing
驚異|wonder, miracle, amazement, prodigy
分子|molecule
麻酔|anaesthesia, anesthesia
財|fortune, riches
街道|highway (esp. one existing from the Edo period), main road
農地|agricultural land, farmland
錯覚|optical illusion, hallucination
兵器|arms, weapon, ordnance
怪獣|monster
共鳴|resonance
音色|tone color, tone colour, tone quality, timbre
処罰|punishment, penalty
潜水|diving, submerging, going underwater
迫害|persecution, oppression
旅客|passenger
融資|financing, loan
行政|executive, government
気象|weather (conditions)
化石|fossil
国土|country, territory, domain, realm
株式|share (in a company), stock
繊維|fibre, fiber, textile
合唱|singing together, singing in union, chorus
差異|difference, disparity, gap
脚本|script, screenplay, scenario
茎|stalk, stem
封鎖|blockade, lockdown, sealing off (an area)
共感|sympathy, empathy, response, identification (with someone)
軍事|military affairs
参議院|House of Councillors (upper house of the National Diet of Japan)
花粉|pollen
窒息|suffocation, choking, asphyxia
刑罰|(criminal) punishment, penalty, sentence
炭素|carbon (C)
血管|blood vessel, vein
修士|"master's (academic degree)"
楽譜|score, sheet music
没収|forfeiture, seizure, confiscation, impounding
軌範|model, standard, pattern, norm, criterion, example
主体|main constituent, core, nucleus
同志|like-mindedness, (being of the) same mind, shared sentiment
岩石|rock
沼|marsh, swamp, wetland, bog, pond
手錠|handcuffs, manacles
演出|direction (of a play, film, etc.), production
給食|provision of lunch (e.g. at office, school, etc.), providing a meal, lunch service
衛生|hygiene, sanitation, health
溶液|solution (liquid)
語源|origin of a word, derivation of a word, etymology
書評|book review
捕鯨|whaling, whale hunting, whale fishing
動力|power, motive power
多数決|majority decision, majority vote, majority rule
盾|shield, buckler, escutcheon, pretext
粥|thin rice porridge, watery cooked rice, rice gruel, congee
織り|weave, weaving, woven item
星座|constellation
軍艦|warship, battleship
保守|maintenance
雪崩|avalanche, snowslide
鉄棒|iron rod, iron bar, iron club
主権|sovereignty, supremacy, dominion
味覚|taste, palate, sense of taste
舗装|paving (a road), surfacing (with asphalt, concrete, etc.), pavement
結核|tuberculosis, TB
根回し|laying the groundwork, behind-the-scenes maneuvering, consensus-building process
放射|radiation, emission
偽造|forgery, counterfeiting, fabrication, falsification
光沢|brilliance, polish, lustre, luster, glossy finish
鳥居|torii (Shinto shrine archway)
自我|ego
燃焼|burning, combustion
執着|attachment, adhesion, insistence, tenacity, fixation, obsession, clinging (e.g. to old customs)
定食|set meal, special (of the day)
合成|composition, synthesis, compounding, combining
新|new, neo-
無知|ignorance, innocence, stupidity
崖|cliff, precipice
嫉妬|jealousy, envy
混同|confusion, mixing, merger
顎|jaw, chin
蜂蜜|honey
藁|straw
蕾|(flower) bud
無口|taciturn, reticent, quiet, silent, untalkative
語彙|vocabulary, lexicon, lexis, terminology
麻痺|paralysis, palsy, numbness, stupor
夕焼け|evening glow, red sunset, afterglow (of sunset)
杖|cane, walking stick, staff, wand
現像|development (of film), photographic processing
片思い|unrequited love, one-sided love
逆立ち|handstand, headstand
直感|intuition, instinct, hunch
班|group, party, team
満月|full moon
貝殻|seashell, shell
元素|element, chemical element
裸足|barefoot
模倣|imitation, copying
滴|drop (e.g. of water), drip
名札|name plate, name tag, label
畜生|"damn it, damn, son of a bitch, for Christ's sake"
近視|myopia, shortsightedness, nearsightedness
器官|organ
海流|ocean current
略語|abbreviation, acronym
助詞|particle, postpositional word in Japanese grammar that functions as an auxiliary to a main word
暗示|hint, suggestion, clue, implication
炬燵|kotatsu, table over an electric heater, with a hanging quilt to retain heat (orig. over a charcoal brazier in a floor well)
降水|rainfall, precipitation
壷|pot, jar, vase
時刻表|timetable, schedule
刺繍|embroidery
香辛料|spice, spices, condiment
自転|rotation (on an axis)
葦|common reed (Phragmites australis)
年鑑|yearbook, almanac, annual
手芸|handicrafts
風車|windmill, wind turbine
絶版|out of print
聴診器|stethoscope
浮力|buoyancy, floating power
暗算|mental arithmetic
映写|projection
上司|"(one's) superior, (one's) boss, the higher-ups"
手元|at hand, on hand, nearby, close at hand
一切|all, everything, entirety, the whole
不当|unfair, unjust, wrongful, improper, unreasonable, unwarranted, unjustified, undeserved, undue
寒気|chill, the shivers, shivering fit
開拓|reclamation (e.g. of wasteland), cultivation, development
田園|the country, countryside, rural districts
鉱山|mine (ore)
振興|promotion, encouragement
万能|all-purpose, utility, universal
円満|harmonious, peaceful, happy, amicable, smooth, free from trouble
市街|urban areas, the streets, town, city
無線|radio (communication)
遠方|long way, distant place
花壇|flower bed
十字路|crossroads, intersection
団扇|uchiwa, type of traditional Japanese handheld fan
丈|height, stature
何と|what, how
俺|I, me
助け|assistance, help, aid, support, reinforcement
真実|truth, reality
傍ら|side, edge, beside, besides, nearby
同意|agreement, consent, approval, assent
事業|business, enterprise, venture, (commercial) activity, (business) operation, industry
勤勉|diligent, hard-working, industrious
確信|conviction, belief, confidence
本の|mere, only, just, slight
行為|act, deed, conduct
興奮|excitement, stimulation, agitation, arousal
非難|criticism, blame, censure, attack, reproach
倶楽部|club, fraternity, sorority, clubhouse
受け入れる|to accept, to receive, to agree
貧乏|poverty-stricken, destitute, poor, penurious
兵士|soldier
賢明|wise, sensible, well-advised, intelligent, sagacious, prudent
過ぎ|past, after
申し出|proposal, offer, request, application
犠牲|sacrifice
支持|support, backing, endorsement, approval
見込み|hope, promise, possibility, chance, probability, likelihood
立ち寄る|to drop in (at), to drop by, to call at, to stop by, to stop off, to stop in
勝る|to excel, to surpass, to exceed, to have an edge, to be superior, to outrival
匹|counter for small animals
直面|confrontation
当て|aim, object, purpose, end
癌|cancer
廃止|abolition, discontinuance, discontinuation, repeal, annulment
余地|place, room, margin, scope
一部|one part, one portion, one section
発言|statement, remark, observation, utterance, speech, proposal
上昇|rising, ascending, climbing
告げる|to tell, to inform, to announce
襲う|to attack, to assail, to make an assault, to strike, to hunt down
従業員|employee, worker
何より|above anything else, above all, more than anything
達成|achievement, attainment, accomplishment, realization
誠実|sincere, honest, faithful
侮辱|insult, affront, slight, contempt (e.g. of court)
言い訳|excuse
負う|"to carry on one's back, to bear, to shoulder"
資金|funds, capital
対処|dealing with, coping with
指摘|pointing out, identification
曲|composition, piece of music, song, track (on a record)
保つ|to keep, to preserve, to hold, to retain, to maintain, to sustain
従事|engaging in (work), pursuing (e.g. studies), following (a profession), being involved in
素早い|quick, swift, nimble, agile
昇進|promotion, advancement, rising in rank
退職|retirement, resignation
浪費|waste, extravagance
拒否|refusal, rejection, denial, veto
提供|offer, tender, providing, supplying, making available, donating (blood, organs, etc.)
討論|debate, discussion
抗議|protest, objection
驚き|surprise, astonishment, wonder, amazement
詳細|details, particulars, specifics
真相|truth, real situation
日々|daily, everyday
広まる|to spread, to be propagated
本気|seriousness, earnestness, truth, sanctity
指示|indication, denotation, designation
負傷|injury, wound
沈黙|silence, being silent, quiet, hush
及ぶ|to reach, to amount to, to befall, to happen to, to extend, to go on (for, until)
誘惑|temptation, allurement, lure, enticement, seduction
採用|use, adoption, acceptance
忠実|faithful, devoted, loyal, honest, true
部下|subordinate person
設立|establishment, founding
一面|one face, one surface
成り立つ|to consist of, to be made up of, to be composed of
事柄|matter, thing, affair, circumstance
満たす|"to satisfy (conditions, one's appetite, etc.), to meet (e.g. demands), to fulfill, to gratify"
過ち|fault, error, indiscretion, faux pas
控える|to be temperate in, to refrain, to abstain, to hold back, to restrain oneself from excessive ...
扱い|treatment, service, dealing (with), handling, management
辞職|resignation
損失|loss (of assets, profit, etc.)
時折|sometimes, at intervals, occasionally, on occasion, from time to time
逃れる|to escape
赤字|(being in) the red, deficit
緊急|urgency, emergency
開発|development, exploitation (of resources)
行い|deed, act, action
出世|success in life, getting ahead, successful career, promotion, climbing the corporate ladder, eminence
購入|purchase, buying
任命|appointment, nomination, ordination, commission, designation
不可欠|indispensable, essential
敏感|sensitive, alert, aware, susceptible
勤務|service, duty, work
発生|occurrence, incidence, outbreak, birth (e.g. of civilization)
辛うじて|barely, narrowly, only just, with difficulty
動き|movement, move, motion
申し込み|application, entry, request, subscription, offer, proposal, overture, challenge
付き|furnished with, including
残酷|cruel, brutal, ruthless, merciless, inhuman
悩ます|to afflict, to torment, to harass, to molest
英雄|hero, heroine, great person
収集|collecting, accumulating, gathering
体験|(practical) experience, personal experience, hands-on experience, first-hand experience
栽培|cultivation
獲得|acquisition, possession
不在|absence
値引き|price reduction, discount
号|number, edition, make, model, issue, part of that group
応募|application, subscription, entry (competition, raffle, etc.), enlistment
悩み|trouble, troubles, worry, distress, sorrows, anguish, agony, problem
継ぐ|to succeed (a person, to a position, etc.), to inherit, to take over, to follow
悪化|deterioration, getting worse, worsening, aggravation, degeneration, corruption
用紙|blank form
減少|decrease, reduction, decline
討議|debate, discussion
生かす|to make (the best) use of, to put to good use, to leverage (skills, attributes, experience, etc.), to capitalise on (experience, etc.)
不況|depression, recession, slump
気楽|carefree, comfortable, at ease
盗み|stealing, theft
念|sense, idea, thought, feeling
伝達|transmission (e.g. news, chemical signals, electricity), communication, delivery, conveyance, transfer, relay, propagation, conduction
野心|ambition, aspiration
開催|holding (a conference, exhibition, etc.), opening, hosting (e.g. the Olympics)
依存|dependence, reliance
通常|usual, ordinary, normal, regular, general, common
大衆|general public, the masses
根拠|basis, grounds, foundation, reason, authority
施設|institution, establishment, facility
催す|to hold (an event), to give (a dinner, party, etc.)
美術|art, fine arts
観点|point of view, viewpoint, standpoint, perspective, angle
対応|correspondence (to), equivalence
連中|company, lot, people, bunch, gang, pack, guys, group, folks
覚え|memory, sense, experience
要する|to need, to demand, to take, to require
試み|attempt, trial, experiment
推測|guess, conjecture
意図|intention, aim, design
特有|characteristic (of), peculiar (to)
過労|overwork, strain
階級|(social) class
禁じる|to forbid, to ban, to prohibit
策|plan, policy, means, measure, stratagem, scheme
合意|(coming to an) agreement, consent, mutual understanding, accord, consensus
像|image, figure, statue, picture, portrait
所属|belonging to (a group, organization, etc.), affiliation (with), being attached to, being under the control of, serving (in the military, congress, etc.)
課題|subject, theme, issue, matter
浜辺|beach, foreshore
地元|home area, home town
始発|first departure (of the day), first train, first bus
沸騰|boiling, seething
大胆|bold, daring, audacious
職務|professional duties
挑戦|challenge, defiance, dare, attempt, try
見方|viewpoint, point of view, way of looking (at something), view, angle
断然|firmly, flatly, resolutely, decisively, absolutely, definitely
決意|decision, determination, resolution
頻繁|frequent, incessant
有益|beneficial, profitable, useful, helpful, instructive
調和|harmony, accord, reconciliation, agreement
蝶|butterfly
処分|disposal, throwing away, selling off
到達|reaching, attaining, arrival
反する|to be contrary (to), to go against, to run counter (to), to contradict, to be opposite (to)
人柄|personality, character, personal appearance, gentility
極端|extreme, extremity
同士|fellow, mutual, companion, comrade
独自|original, unique, distinctive, characteristic, peculiar
励ます|to encourage, to cheer on, to cheer (someone) up
接触|touch, contact, touching
中断|interruption, suspension, break
好意|kindness, favor, favour, friendliness
合併|merger (of companies, towns, etc.), combination, union, amalgamation, consolidation, coalition, fusion, annexation, affiliation, incorporation
肉体|"the body, the flesh, the outer man, one's physique"
発|departure, departing from ..., leaving at (e.g. 8:30)
弁解|"explanation (e.g. for one's actions), excuse, justification, defense, defence"
崩壊|collapse, crumbling, breaking down, caving in
登校|attendance (at school), going to school
観衆|spectators, onlookers, members of the audience
業者|trader, dealer, businessperson, company, vendor, supplier, manufacturer, maker, contractor
頑固|stubborn, obstinate, pigheaded
悲鳴|shriek, scream
起源|origin, beginning, source, rise
少数|small number, few, minority
抜け出す|to slip out, to sneak away, to break free, to get through (a difficult situation)
損う|to harm, to hurt, to injure, to damage, to spoil, to mar, to ruin
手配|arrangement, preparations
簡潔|concise, brief, succinct, compact (style)
事項|matter, item, facts
手掛かり|clue, lead, key, trail, scent, track
慣習|custom, convention, common practice
野生|wild, growing wild, living in the wild
促進|promotion, acceleration, encouragement, facilitation, spurring on
読者|reader
創立|establishment, founding, organization, organisation
情熱|passion, enthusiasm, zeal
成果|"(good) result, outcome, fruits (of one's labors), product, accomplishment"
情勢|state of things, state of affairs, situation, conditions, circumstances
閉鎖|closing, closure
背景|background, scenery, backdrop, setting
法廷|court (of law), courtroom
源|source (of a river), fountainhead
向上|elevation, rise, improvement, advancement, progress
要請|appeal, call for something, request, claim, demand
受け継ぐ|to inherit, to succeed, to take over
脅す|to threaten, to menace, to frighten (into doing)
異議|objection, dissent, protest
再会|meeting again, reunion
無駄遣い|waste (of money, time, etc.), squandering, frittering away
恐れ|fear, horror, anxiety, concern, uneasiness, reverence
余暇|leisure, leisure time, spare time
見通し|unobstructed view, perspective, visibility, vista
紛争|dispute, conflict, trouble, strife
獲物|prey, catch, kill, game
行進|march, parade
経費|expenses, expenditure, outgoings, outlays, costs
微笑|smile
滑らか|smooth (of a surface), glassy, velvety, soft
干渉|interference, intervention, meddling
業績|achievement, performance, results, work, contribution
争い|fight, dispute, feud, conflict, struggle, strife, discord, argument, quarrel, controversy
経歴|personal history, background, career
決勝|decision of a contest, finals (in sports)
要因|main cause, primary factor
抑制|control, restraint, suppression, constraint, curtailment, inhibition, check, curb
教訓|lesson, precept, teachings, moral
言論|"(one's) speech, expression of views, discussion"
怠慢|negligence, neglect, carelessness, procrastination
高まる|to rise, to swell, to be promoted
国連|United Nations, UN
入手|acquisition, obtaining, procurement, getting (hold of)
参照|reference (e.g. to a dictionary, passage, footnotes), consultation, comparison
訂正|correction, revision, amendment
象徴|symbol (of something abstract), emblem, (symbolic) representation
追跡|chase, pursuit, tracking, stalking
利点|advantage, point in favor, point in favour
匹敵|to be a match for, to rival, to equal, to compare with, to be equivalent to
上演|performance (of a play, opera, etc.), staging, presentation
活発|lively, active, vigorous, animated, brisk
衣類|clothes, clothing, garments
部門|division (of a larger group), branch, field, class (subclass), group, category, department
並|average, medium, common, ordinary
大げさ|exaggerated, overdone, overblown, hyperbolic, bombastic, grandiose
大幅|big, large, drastic, substantial
特権|privilege, special right
負担|burden, load, responsibility
使い|errand, mission, going on an errand
増し|better, preferable, less objectionable, least-worst
頼み|request, favor, favour
名簿|register of names, list of names, roll, register, roster
軌道|orbit, trajectory
当選|being elected
墜落|fall, crash (e.g. aircraft)
諸君|you (people)
著名|well-known, noted, celebrated
健全|healthy, sound, wholesome
単調|monotony, monotone, dullness
警戒|vigilance, caution, alertness, precaution, being on guard
迅速|quick, fast, rapid, swift, prompt, streamlined, expedited, expeditious
一連|series, chain, sequence
正常|normalcy, normality, normal
論議|discussion, argument, debate
見地|point of view, viewpoint, standpoint
追放|exile, banishment, eviction, deportation, purge, expulsion, ousting
密接|close (relationship, connection, etc.), intimate, near
日取り|fixed date, appointed day
交互|alternate, alternating
背後|back, rear
歓声|cheer, shout of joy
確立|establishment, settlement
処置|measure, step, dealing with
登録|registration, accession, register, entry, record
打ち込む|to drive in (a nail, stake, etc.), to hammer in
免除|exemption, exoneration, discharge
武装|arms, armament, taking up arms, arming oneself
青春|youth, springtime of life, adolescent
団結|unity, union, solidarity, combination, banding together, teaming up
打撃|blow, shock, strike, damage
確保|securing, obtaining, ensuring, guarantee, maintaining
展示|exhibition, display
何だか|(a) little, somewhat, somehow
鮮やか|vivid, bright, brilliant, clear, fresh, vibrant
要望|demand for, request
定める|to decide, to determine
知的|intellectual
監視|monitoring, watching, observation, surveillance, guarding, supervision, lookout
浴室|bathroom
鉄鋼|iron and steel
問う|to ask, to inquire
唱える|to recite, to chant
腕前|ability, skill, facility
上空|sky, the skies, high-altitude sky, upper air
協定|arrangement, pact, agreement
訴訟|litigation, lawsuit
堂々|magnificent, grand, impressive, dignified, majestic, imposing, stately
軽率|rash, thoughtless, careless, hasty, imprudent
侵略|invasion (e.g. of a country), raid, aggression
着|arrival, arriving at ...
提示|presentation (of a passport, ID, etc.), showing, production (e.g. of documents)
雌|female (animal, plant)
会見|interview, audience, meeting, (viewing) party
当たり|hit
望ましい|desirable, hoped for, preferable, advisable
出費|expenses, disbursements
貯蓄|savings
秩序|order, discipline, regularity, system, method
良質|good quality, fine quality, superior quality, high quality
排除|exclusion, removal, elimination, clearing away, getting rid of
削減|cut, reduction, curtailment
票|vote, ballot
施す|to give (time, money, goods), to donate
分配|division, splitting, sharing, distribution, dissemination, allocation
自立|independence, self-reliance
逃走|flight, desertion, escape
前途|future, prospects, outlook
主題|subject, theme, motif
内部|interior, inside, internal
返答|reply, answer
協会|association, society, organization, organisation
教科|subject, curriculum
晴天|fine weather (i.e. little or no clouds), fair weather, clear weather, clear sky, fair skies
業務|business, affairs, duties, work, procedure, task, action, function, (business) operations, operational
宣言|declaration, proclamation, announcement
出演|appearance (in a film, play, TV show, etc.), performance
恵み|blessing, grace
側面|side, flank, profile, sidelight, lateral
単独|sole, single, solo
放棄|abandonment, renouncement, renunciation, resignation, abdication, surrender, relinquishing, waiving, giving up
指揮|command, direction, supervision
暴露|disclosure, exposure, revelation
出産|childbirth, (giving) birth, delivery, parturition
家計|household economy, family finances
申告|report, return (e.g. tax), statement, declaration, notification, filing
育ち|growth, breeding
欲望|desire, appetite, lust
交わす|to exchange (messages, greetings, arguments, etc.)
樹立|establishment, founding, setting (a record)
危害|injury, harm, danger
配置|arrangement (of resources), deployment, stationing, posting, disposition, configuration, layout
原則|principle, general rule
趣旨|meaning, point (e.g. of a statement), gist, effect
優先|preference, priority, precedence
猛烈|fierce, intense, severe, violent, strong, vehement, terrific, terrible
所得|income, earnings
除外|exception, exclusion
募る|to become stronger, to grow in intensity, to grow violent, to become worse
判定|judgement, judgment, decision, ruling, finding, adjudication, verdict, call
色彩|colour, color, hue, tints
風習|custom
制|system, organization, organisation, imperial command, laws, regulation, control, government, suppression, restraint, holding back, establishment
成年|adult age, majority
生理|physiology
措置|measure, step, action
運営|management, administration, operation
神聖|holiness, sacredness, sanctity, dignity
熱意|zeal, enthusiasm, ardor, ardour
保管|charge, custody, safekeeping, deposit, storage
原文|original text
不動産|real estate
導入|introduction, bringing in, installation, setting up, importation
進行|moving forward (e.g. of a vehicle), onward movement
避難|taking refuge, finding shelter, evacuation, escape, seeking safe haven
追い出す|to expel, to drive out
移住|migration, immigration
破裂|bursting, rupture, explosion
従来|up to now, so far
孤立|isolation, being alone, being friendless
土手|embankment, bank
後退|retreat, falling back, moving backwards, reversing, backing up (of a vehicle), retrogression, retraction
把握|grasp (of the situation, meaning, etc.), understanding, control, hold, grip
理屈|theory, reason, logic
作用|action, operation, process, agency, effect, function
写し|copy, duplicate, facsimile, transcript
借り|borrowing, debt, loan
効率|efficiency
早める|"to bring forward (e.g. by 3 hours), to advance, to hasten (e.g. one's death), to expedite, to precipitate"
手順|process, procedure, sequence, protocol, instruction
脈|pulse
配布|distribution
憤慨|indignation, resentment
不景気|economic slump, hard times, depression, recession
衣装|clothing, costume, outfit, garment, dress
新築|new building, new construction
一同|all present, all concerned, all of us
襲撃|(surprise) attack, assault, raid, charge
苦しめる|to torment, to pain, to inflict (physical) pain, to hurt
転落|fall, tumble, spill, plunge, dive
惜しむ|to be frugal, to be sparing
待遇|treatment, reception, service
不明|unclear, obscure, indistinct, uncertain, ambiguous
意向|intention, idea, inclination, wish
落ち葉|fallen leaves, leaf litter, falling leaves
素材|ingredient, (raw) material, resource
押し込む|to push into, to cram into, to stuff into, to crowd into
使命|mission, errand
対抗|opposition, rivalry, competition, antagonism
駆ける|to run, to dash, to race
歩み|walking
届|report, notification, registration
発育|(physical) growth, development
果て|the end, the extremity, the limit, the limits, the result
追い込む|to herd, to drive, to chase, to corral
優勢|superiority, superior power, predominance, preponderance
公演|public performance
任す|"to entrust (to someone), to leave (in someone's hands)"
実質|substance, essence
突破|breaking through, breakthrough, penetration
無断|absence of permission, lack of permission
募金|fund-raising, collection of funds
役職|post, official position
雇用|employment, hire
細菌|bacterium, bacteria, germ
終始|beginning and end
収支|income and expenditure
技能|technical skill, ability, capacity
議案|legislative bill, measure
議題|topic of discussion, agenda
集計|totalization, totalisation, aggregation, tally (e.g. of votes), adding up, summing up
同感|same feeling, same sentiment, same opinion, sympathy, agreement, concurrence
異論|different opinion, objection
進展|progress, development
記載|mention (in a document), record, entry, statement, listing
人材|capable person, talented person
豊作|abundant harvest, bumper crop
勢力|influence, power, might, strength, potency, force, energy
報じる|to inform, to report
正当|just, justifiable, right, due, proper, equitable, reasonable, legitimate, legal, lawful
盛大|grand, magnificent, lavish, large scale, prosperous, thriving, lively
強烈|strong, intense, severe
物資|goods, materials, commodities, resources, supplies
装備|equipment
多様|diverse, varied
脱する|to escape from, to get out
取り扱い|treatment, service, handling, management
仕組み|structure, construction, arrangement, contrivance, mechanism, workings
限定|limit, restriction
強硬|firm, strong, unbending, unyielding, uncompromising, stubborn, tough, hard-line
沈没|sinking, foundering, going down, submersion
痛感|feeling keenly, fully realizing
連休|consecutive holidays
好評|favorable reception, good reputation, popularity
備わる|to be furnished with, to be provided with, to be equipped with
無用|useless, futile
不良|bad, poor, inferior, defective
悲惨|disastrous, tragic, miserable, wretched, pitiful, woeful
繁殖|breeding, propagation, reproduction, multiplication, increase
荷|load, baggage, cargo, freight, goods
引き取る|"to take into one's possession, to receive, to accept, to collect, to claim"
辞退|declining, refusal, nonacceptance, turning down, withdrawal (e.g. of candidacy), pulling out (e.g. of a race), excusing oneself
介入|intervention
引きずる|to drag, to trail, to pull along the ground, to lug
奨励|encouragement, promotion, inducement, incitement, stimulation
飼育|breeding, raising, rearing
換算|conversion (e.g. yen to dollars), change, exchange, translation (numerical)
緩やか|loose, slack
関与|participation, taking part in, participating in, being concerned in
兆し|sign, indication, omen, symptom
主任|person in charge, senior staff, manager, chief, head
掲げる|to put up (a notice, sign, etc.), to hang out (e.g. a banner), to fly (e.g. a flag), to hoist, to raise, to display
規模|scale, scope, plan, structure
有力|influential, prominent
情|feelings, emotion, sentiment
協議|conference, consultation, discussion, negotiation
強める|to strengthen, to emphasize, to emphasise
黒字|(being in) the black, surplus
制する|to hold back (e.g. emotions), to rein in (e.g. a horse, unruly people), to bridle
雨天|rainy weather
不服|dissatisfaction, discontent, disapproval, objection, complaint, protest, disagreement
会談|talks (i.e. formal discussions), conference, meeting
変動|change, fluctuation
結びつく|to be related, to be connected, to be joined together
領土|dominion, territory, possession
捜査|search (esp. in criminal investigations), investigation, inquiry, enquiry
増進|promoting, increase, advance
体格|build, physique, frame, constitution
代用|substitution
再生|restoration to life, coming to life again, resuscitation, regeneration
荒廃|ruin, destruction, devastation, waste, decay
弁護|defense, defence, pleading, advocacy
始末|management, dealing with, settlement, cleaning up, disposal
暴風|storm, windstorm, gale
固有|characteristic, traditional, peculiar, inherent, native, eigen-
中毒|poisoning
流し|sink (e.g. in a kitchen)
救援|relief, rescue
願書|(written) application, written request, petition
膨張|expansion, swelling, increase, growth
破棄|tearing up and discarding (e.g. documents), destruction
点検|detailed inspection, thorough examination, checking
叫び|shout, cry, outcry, yell, shriek, scream
陶器|pottery, earthenware, ceramics, (soft-paste) porcelain, china
進出|advance (into a new market, industry, etc.), expansion (into), launch (into), entering, making inroads (into)
奮闘|strenuous effort, hard struggle, working hard
学説|theory
達者|in good health, healthy, well, fit, robust, strong
優美|grace, refinement, elegance, daintiness
期末|end of term
気軽|carefree, buoyant, lighthearted, sprightly
配慮|consideration, concern, attention, thoughtfulness, making arrangements, care, trouble
依然|still, as yet, as it has been
進路|route, course, path
招き|invitation
衣料|clothing
心地|feeling, sensation, mood
上陸|landing, going ashore, disembarkation
日夜|day and night, around the clock, always, constantly
同盟|alliance, union, league
終日|all day, for a whole day
寄与|contribution, service
成熟|maturity, ripeness
変革|change, transformation, reform, revolution, revolutionizing, innovation, upheaval
制裁|sanctions, punishment
制定|enactment, establishment, creation
乙|(the) second (party, rank, etc.), B (grade), the latter
前例|precedent
結合|combination, union, joining, linking, coupling
形勢|condition, situation, prospects
究極|ultimate, final, last, eventual
決議|resolution, vote, decision
補償|compensation, reparation
用品|articles, supplies (e.g. office supplies), things (for), utensils, goods, equipment
厳密|strict, close, precise, scrupulous
当人|the person concerned, the person in question, the said person
論理|logic
交える|to mix, to combine, to include
分離|separation, partition, detachment, segregation, isolation
審議|deliberation, discussion, consideration
公然|open, public, official, overt
動向|trend, tendency, movement, attitude
裏返し|inside out, upside down
扶養|"support (e.g. of one's dependents), maintenance"
放出|release, emission, ejection
種々|various, a variety of, all kinds of, many, diverse
口頭|oral, verbal, spoken, parol
庶民|common people, ordinary people, masses
証|proof, evidence, sign, testimony, testament (to something), vindication
回収|collection, recovery, withdrawal, retrieval
福|good fortune, happiness, blessing, good luck
非行|delinquency, misconduct
武力|armed might, military power, the sword, force
粉末|fine powder
弁論|discussion, debate, argument
雑談|chatting, idle talk
補充|replenishment, supplementation, supplement, replacement, refilling
系|system, lineage, group
至って|very much, exceedingly, extremely
使い道|purpose, utility, objective
夕暮れ|evening, dusk, twilight
補助|assistance, support, help, aid
視察|inspection, observation
学歴|academic background, academic credentials, academic record
社交|social life, social intercourse
圧迫|pressure
意地|stubbornness, obstinacy, willpower, pride
深める|to deepen, to heighten, to intensify
割り当て|allotment, assignment, allocation, quota, rationing
簡素|simple, plain, modest
護衛|guard, convoy, escort
群|group, bunch, crowd, throng, swarm, band
刑|penalty, sentence, punishment
購読|buying and reading (book, magazine, etc.), subscribing (incl. free subscriptions), taking (e.g. newspaper)
壮大|magnificent, grand, majestic, splendid
沿岸|coast, shore, littoral
対決|confrontation, showdown
加工|manufacturing, processing, treatment, machining
検事|public prosecutor
収まる|to fit into (a box, frame, category, etc.), to be contained within, to fall within (e.g. a budget)
外観|outward appearance, exterior appearance, outward show, looks
信者|believer, adherent, devotee, follower
原作|original work
貧弱|poor, meagre, meager, feeble, scanty, shabby, insubstantial
転じる|to turn, to shift, to alter, to distract
再発|return, relapse, recurrence
滞納|falling behind (with a payment), being in arrears, non-payment, default, delinquency
土台|foundation, base, basis
蓄積|accumulation, accumulate, store
禁物|thing that should be (carefully) avoided, no-no, thing to definitely not do, something forbidden, taboo
出生|birth
生死|life and death, life or death
好況|prosperous conditions, healthy economy, boom
好調|favourable, favorable, promising, satisfactory, in good shape
廃棄|disposal, abandonment, scrapping, discarding, abolition
配分|distribution, allotment
激励|encouragement, spurring (on), cheering (on)
合間|interval, break, pause, spare moment
首脳|head, leader, top
浜|beach, seashore
採択|adoption, selection, choice
強いる|to force, to compel, to coerce, to press, to impose
提携|cooperation, tie-up, joint business, partnership, alliance, sponsorship
新婚|newly-wed, newly married
覆す|to overturn, to capsize, to upset
冷淡|cool, indifferent, apathetic, half-hearted
存続|continuance, survival, persistence, retention, duration
良好|good, fine, excellent, favorable, favourable, satisfactory
方策|plan, policy
志望|wish, desire, ambition, choice
短縮|shortening, contraction, reduction, curtailment, abbreviation
本音|real intention, motive, true opinion, what one really thinks
楽観|optimism, taking an optimistic view
面目|face, honour, honor, reputation, prestige, dignity, credit
投入|throwing in, inserting, depositing (e.g. a ballot)
模範|exemplar, model, example, pattern
上がり|rise, increase, ascent
事前|prior, beforehand, in advance, before the fact, ex ante
侍|warrior (esp. of military retainers of daimyos in the Edo period), samurai
個々|individual, one by one, separate, each
様式|style, form, pattern
屋敷|residence, estate, grounds, premises, mansion
舞う|to dance (orig. a whirling dance)
悲観|pessimism, (taking a) gloomy view, discouragement, despondency, despair, disappointment
手がける|to handle, to manage, to deal with, to work with, to have experience with
一帯|whole area, whole region
受け入れ|receiving, acceptance, reception
交付|delivery, issuance, handing over, granting
宿命|fate, destiny, predestination
上位|superior (in rank), top, ranking
侵す|to invade, to raid, to violate (airspace, etc.), to intrude, to trespass
油絵|oil painting
訴え|lawsuit, complaint
塾|cram school, private tutoring school, juku
総会|general meeting
未婚|unmarried, not yet married
応急|emergency, first-aid
原油|crude oil
協調|cooperation, conciliation, harmony, coordination
後回し|putting off, postponing
真上|just above, right overhead
調べ|investigation, inspection, examination
調印|signature, signing, sealing
掲載|publication (e.g. of an article in a newspaper), carrying (e.g. a story), running (e.g. a serial), insertion (e.g. of an advertisement), printing, posting (e.g. on the web)
定まる|to become settled, to be fixed
展望|view, outlook, prospect
正解|correct answer, right solution, correct interpretation
投げ出す|"to throw down, to throw out, to stretch out (one's legs)"
個別|individual, separate, personal, case-by-case
河川|rivers
公立|public (institution)
内臓|internal organs, viscera
工作|handicraft
巧妙|ingenious, skillful, clever, deft
逆転|reversal (of a situation), turnaround, turnabout, turning the tables, sudden change
捕獲|capture, seizure
配給|distribution (e.g. films, rice)
未熟|unripe, green
改訂|revision (of text), alteration, change
眉|eyebrow, eyebrows
根気|patience, perseverance, persistence, tenacity, energy
街頭|(on the) street
走行|running (of a car, bus, etc.), traveling, travelling
外貨|foreign currency, foreign money, foreign exchange
外相|Foreign Minister
採算|profit
復旧|restoration, restitution, rehabilitation
便宜|convenience, accommodation, advantage, benefit, expediency
譲歩|concession, conciliation, compromise
雑貨|miscellaneous goods, general goods, sundries
編|compilation (of a text), editing
放射能|radioactivity
酸化|oxidation, oxidization
方式|form, method, system, formula
一括|lumping together, summing up, bundle, lump, batch
移行|transition, changeover, switchover, shift
予感|presentiment, premonition, hunch
老衰|senility, senile decay, infirmity (through age)
器|bowl, vessel, container
手法|technique, method
趣|meaning, tenor, gist
中傷|slander, libel, defamation, calumny, smear
命中|(direct) hit, hitting the mark
受け止める|to catch, to stop the blow
教え|teaching, instruction, teachings, precept, lesson, doctrine
利息|interest (on a loan, deposit etc.)
華やか|bright and beautiful, gorgeous, showy, brilliant, splendid, gay, colorful, flowery
受身|the defensive
取材|gathering material (for an article, novel, etc.), collecting information, covering (an event, incident, etc.), reporting, interview (for a news story)
引き下げる|to pull down, to lower, to reduce, to withdraw
一部分|one part, one portion, one section
本文|text (of a book, document, etc.), body (of a letter)
議決|resolution, decision, vote
審査|judging, inspection, examination, investigation, review
神殿|temple, shrine, sanctuary
推理|reasoning, inference, deduction
設置|establishment, institution
全盛|height of prosperity
補強|reinforcement, strengthening
阻む|to keep someone from doing, to stop, to prevent, to check, to hinder, to obstruct, to oppose, to thwart
結成|formation, combination
液|liquid, fluid
打ち切る|to stop, to abort, to discontinue, to close
育成|rearing, training, nurture, cultivation, promotion
態勢|attitude, posture, preparedness, readiness
単一|single, simple, sole, individual, unitary
仕上がり|finish, end, completion, result
増強|reinforcement, augmentation, strengthening, increase, buildup
控除|subtraction, deduction (e.g. tax), subsidy
頂|crown (of head), summit (of mountain), spire
期日|fixed date, appointed date, set date
実情|real condition, actual circumstances, actual state of affairs
現行|present, current, in operation
追及|"investigation (e.g. into someone's guilt), questioning, pressing, hounding, pinning down"
志向|intention, aim, preference (for), orientation (towards a goal)
天災|natural calamity, disaster
人目|(public) notice, attention, public eye, public gaze
転換|conversion, diversion, changeover, commutation, switchover
落下|fall, drop, descent, coming down
誤差|measurement error, calculation error
連日|day after day, every day
持ち|having, holding, possessing, owning, using, holder, owner, user
中枢|centre, center, pivot, mainstay, nucleus, hub, backbone, central figure, pillar, key person
同等|equality, equal, same rights, same rank, equivalence
失格|disqualification, elimination, incapacity
志|will, resolution, intention, ambition, aim, goal
内訳|itemization (of expenses), the items, breakdown, classification
内乱|civil war, insurrection, rebellion, domestic conflict
肉親|blood relationship, blood relative
日の丸|outline of the Sun (esp. represented as a red circle)
核|stone (of a fruit), pit, pip
耕作|cultivation, farming
売り出す|to put on the market, to put out for sale, to put on sale, to begin selling, to market
合致|agreement, concurrence, conformance, compliance
国防|national defence, national defense
推進|propulsion, drive
砂利|gravel, ballast, pebbles
必修|required (subject)
不審|doubt, suspicion, question, strangeness
布告|edict, ordinance, proclamation
階層|class, level, stratum, layer, hierarchy
生育|birth and growth, giving birth and raising, development, breeding
揺さぶる|to shake, to jolt, to rock, to swing, to sway
様相|aspect, phase, condition
公用|official business, government business, public business, company duties
傾斜|inclination, slant, slope, bevel, list, dip, tilt, lean
法学|law, jurisprudence
防火|fire prevention, fire fighting, fire proof
決算|settlement of accounts, closing accounts, financial results, reporting (of accounts)
指令|orders, instructions, directive, command
誇る|to boast of, to be proud of, to take pride in
名称|name, title
目録|catalogue, catalog, inventory, index, list
時差|time difference
出題|setting a question (for an exam, quiz, etc.)
苗|seedling, young plant
慣行|customary practice, habit, traditional event
磁気|magnetism
主演|starring (in a film, play, etc.), playing the leading part
丸ごと|in its entirety, whole, wholly
実態|true state, actual condition, reality
旅券|passport
反感|antipathy, antagonism, animosity, revulsion, ill feeling
誘導|guidance, leading, induction, introduction, incitement, inducement
拘束|restriction, restraint, binding, constraint
既婚|married
利潤|profit, returns
規約|agreement, rules, code, protocol, convention, bylaw
技|technique, art, skill, move
略奪|pillage, plunder, looting, robbery
初版|first edition
確定|decision, settlement, confirmation, establishment
売り出し|(bargain) sale
意気込む|to be enthusiastic (about), to be eager (to do), to be keen, to be intent (on), to be determined
前売り|advance sale, booking
休戦|cease-fire, truce, armistice
張り紙|paper patch attached to something, paper backing, sticker, label
取り締まり|control, management, supervision
心情|"sentiment, emotions, one's feelings, one's heart"
凶作|bad harvest, poor crop
読み上げる|to read out, to read aloud, to call out
親しむ|to be intimate with, to befriend
身近|near oneself, close to one, familiar
進み|progress
邸宅|(large) house, residence, mansion
教材|teaching materials
抗争|rivalry, feud, conflict, dispute, struggle, strife, contention, resistance
郷愁|nostalgia, homesickness
是正|correction, revision, redressing, rectifying
切れ目|gap, break, rift
制約|limitation, restriction, condition, constraints
精巧|elaborate, delicate, exquisite
精密|precise, exact, detailed, accurate, minute, close
税務署|tax office
責務|duty, obligation
軍備|armaments, military preparations
経路|course, route, path, channel
国産|domestically produced, domestic, Japanese-made
振り出し|shaking (something) out
劇団|troupe, theatrical company
相場|market price
反撃|counterattack, counteroffensive, counterblow
体裁|(outward) appearance
対比|contrast, comparison
自在|being able to do as one pleases, doing at will
敗戦|defeat, lost battle, losing a war
所定|prescribed, designated, appointed, fixed
下火|burning low, waning, declining
先行|going ahead, going first
不順|irregular, unseasonable, changeable, unsettled, abnormal
聴講|lecture attendance, auditing
寛容|tolerance, open-mindedness, forbearance, generosity, magnanimity
不評|bad reputation, poor reception, unpopularity, disrepute
長官|secretary (government), director, chief
長編|long (e.g. novel, film)
適性|aptitude, aptness, suitability
養成|training, education, development, cultivation
症|illness, condition, -pathy
電源|source of electricity, electrical power
排水|drainage, draining, pumping out (water), sewerage
特集|feature (e.g. newspaper), special edition, report
粘り|stickiness, viscosity
無難|safe (e.g. choice), secure, innocuous, inoffensive
大空|wide open sky, the blue, heavens, firmament
行員|bank clerk
購買|procurement, purchase, buying
配偶者|spouse, wife, husband, partner
賠償|compensation, reparations, indemnity, damages
否決|rejection, negation, voting down
お産|(giving) birth, childbirth, delivery
比率|ratio, proportion, percentage
共働き|(husband and wife) both working, dual income
打開|break in the deadlock
外来|foreign, imported
採集|collecting, gathering
覆面|mask, veil, disguise
物議|public discussion, public criticism, controversy
同居|living together, coexistence
変遷|change, transition, vicissitudes
学芸|arts and sciences, liberal arts
補足|supplement, complement
下位|low rank, lower position, subordinate position, lower order (e.g. byte)
母校|alma mater
峰|peak, summit, ridge, top
問屋|wholesale store, wholesale dealer, wholesaler
一変|complete change, about-face
勧告|advice, counsel, remonstrance, recommendation
民宿|guest house, private home providing lodging for travelers, bed and breakfast, pension
選考|selection, choice, screening
味わい|flavour, flavor, taste
船舶|vessel, ship, shipping, seacraft
格差|qualitative difference, disparity, gap
還元|restoration, return
半端|remnant, fragment, incomplete set, incompleteness
不調|bad condition, poor condition, disorder, slump, being out of form
構想|plan, plot, idea, conception, vision, scheme
主催|"sponsorship (i.e. conducting under one's auspices), promotion, organizing, organising, hosting, staging"
連盟|league, federation, union
根底|root, basis, foundation
手軽|easy, simple, informal, offhand, cheap
女史|lady (of high social status; e.g. scholar, artist, critic, politician)
修了|completion (of a course)
円滑|smooth, undisturbed, uninterrupted, harmonious
寄贈|donation, presentation, gift
胴|trunk, torso, body, abdomen, waist
情緒|emotion, feeling
発足|starting, inauguration, launch, founding, establishment, start-up
着工|starting (construction) work
素朴|simple, artless, naive, unsophisticated
記す|to write down, to note down, to jot down, to take a note of
所在|location (of), position, whereabouts, place where one is
交易|trade, commerce
仕掛け|device, contrivance, mechanism, gadget
採決|vote, ballot, division
建て前|face, official stance, public position or attitude (as opposed to private thoughts)
異性|the opposite sex
据える|to place (in position), to fix, to set (e.g. table), to lay (foundation)
攻め|attack, offence, offense, assault
一概に|unconditionally, as a rule
心得|knowledge, understanding
該当|corresponding to, being applicable to, being relevant to, coming under, falling under, fulfilling (requirements), meeting (conditions), qualifying for
申し入れる|to propose, to suggest
末期|last years, closing years, last days, closing days, end, last stage, final stages, terminal stage (of a disease)
遭難|(meeting with) disaster, (having an) accident, mishap, shipwreck, distress
丘陵|hill, hillock
沿線|places alongside a railway line, bus route, major thoroughfare, etc.
本体|substance, true form, true character
勤め先|place of work
勤労|labor, labour, exertion, diligent service
製鉄|iron manufacture
区間|section (of track, etc.), segment, dimension
製法|manufacturing method, recipe, formula
静止|stillness, repose, standing still
明朗|cheerful, bright
計器|meter, gauge
運輸|transportation
即する|to conform to, to agree with, to be adapted to, to be based on
切実|earnest, sincere, acute, keen, fervent
台本|script, libretto, scenario
原形|original form, base form
名残|remains, traces, vestiges, relics
優位|predominance, superiority, ascendancy, advantage, supremacy
並びに|and (also), both ... and, as well as
本場|home (of something), place famous for its ..., center (e.g. of manufacture), best place (for)
出品|exhibiting, showing, putting on display, putting up for sale, entering (a work into a competition), submitting
内陸|inland
遣る|to do, to undertake, to perform, to play (a game), to study
直ぐ|immediately, at once, right away, directly
間違う|to make a mistake, to be incorrect, to be mistaken
何て|how ...!, what ...!
訪れる|to visit, to call on
易い|easy
忠告|advice, warning
的|-ical, -ive, -al, -ic, -y
近づく|to approach, to draw near, to get close
冊|counter for books
犯す|to commit (e.g. crime), to perpetrate, to make (e.g. mistake)
後悔|regret, repentance, remorse
果たす|to accomplish, to achieve, to carry out, to fulfill, to fulfil, to realize, to execute, to perform, to do
齎す|to bring (news, knowledge, etc.), to introduce
嘗て|once, before, formerly, ever, former, ex-
尽くす|to use up, to exhaust, to run out of
軽蔑|contempt, scorn, disdain, despising, looking down on, slighting
愚か|foolish, stupid, silly
役立つ|to be useful, to be helpful, to serve the purpose
取り戻す|to take back, to get back, to regain, to recover, to restore, to recoup
産む|to give birth, to bear (child), to lay (eggs)
枚|counter for thin, flat objects (e.g. sheets of paper, plates, coins)
養う|to support, to maintain, to provide for
勇敢|brave, heroic, gallant
痛む|to hurt, to ache, to feel a pain
名付ける|to name, to call, to christen, to term
遥か|far away, far off, far, distant, in the distance
極めて|exceedingly, extremely, decisively
部|department (in an organization, company, etc.), division, bureau, faculty
値する|to be worth, to be worthy of, to deserve, to merit
仕上げる|to finish up, to complete, to finish off, to get through, to polish off
最早|already, now
自ずから|naturally, in due course, by itself, of its own accord
空腹|empty stomach, hunger
態々|"expressly, especially, specially, taking the trouble (to do), going to the trouble of (doing), going out of one's way (to do)"
夜更かし|staying up late, keeping late hours, sitting up late at night, nighthawk
済ます|to finish, to get it over with, to conclude
取り除く|to remove, to deinstall, to take away, to set apart
前もって|in advance, beforehand, previously, ahead of time
恥じる|to feel ashamed
捧げる|to lift up, to hold up, to hold above eye level
生まれつき|by nature, by birth, naturally, natural, innate
見渡す|to look out over, to survey (scene), to take an extensive view of
富む|to be rich in, to abound in, to be abundant in, to be full of
如何に|how, in what way
試みる|to try, to attempt, to have a go (at)
相応しい|appropriate, adequate, suitable, fitting, worthy
逃げ出す|"to run away, to flee, to make off, to take to one's heels, to escape"
無礼|rudeness, impoliteness, discourtesy, insolence
受かる|to pass (examination)
完璧|perfect, complete, flawless
取り分け|especially, particularly, above all
況して|still more, to say nothing of, not to mention
費やす|to spend, to expend, to consume
漏らす|to let leak, to let out (e.g. light)
群集|crowd, community, group, herd, gathering, assembly
尚更|still more, even more, all the more
演じる|to act (a part), to play (a role)
費|cost, expense
誠|truth, reality, fact
容易い|easy, simple, light
顔付き|(outward) looks, features, face, countenance, expression
如何にも|indeed, really, truly, just (like)
製|make, manufacture, -made, made of ..., made in ...
嘘つき|liar, fibber
取り組む|to grapple with, to wrestle with, to engage in a bout, to be matched against
目覚める|to wake up, to awake
賭ける|to wager, to bet, to risk, to stake, to gamble
叶う|to come true (of a wish, prayer, etc.), to be realized, to be fulfilled
沿う|to run along, to run beside, to stick to (a line)
悟る|to perceive, to sense, to become aware, to notice, to detect, to discern
員|member
治まる|to die down (storm, anger, conflict, etc.), to calm down, to cool off, to abate, to be settled, to be brought under control
向け|intended for ..., oriented towards ..., aimed at ...
番目|the nth ...
拒絶|refusal, rejection
尽きる|to be used up, to be run out, to be exhausted, to be consumed, to come to an end
お祖父さん|grandfather
害する|to injure, to damage, to harm, to hurt
欠く|to chip, to nick, to break, to crack
奢る|to treat (someone) to (something), to give (someone) a treat, to buy (someone a meal, drink, etc.)
漏れる|to leak out, to escape, to come through, to shine through, to filter out
伴う|to accompany, to go hand in hand with, to be consequent upon
兎角|(doing) various things, (doing) this and that
憂鬱|depression, melancholy, dejection, gloom, despondency
衰える|to become weak, to decline, to wear, to abate, to decay, to wither, to waste away
及び|and, as well as
誤る|to make a mistake (in), to commit an error, to do incorrectly, to err
咎める|to blame, to reproach, to censure, to rebuke, to reprove, to find fault, to take to task, to criticize, to criticise
身振り|gesture, gesticulation, motion
整える|to put in order, to arrange, to tidy up, to fix, to straighten
痛める|to hurt, to injure, to cause pain
込める|to load (a gun, etc.), to charge
差し出す|to present, to submit, to tender, to hold out
摘む|"to pinch, to hold (between one's fingers), to pick up (with chopsticks, tweezers, etc.)"
見逃す|to miss, to overlook, to fail to notice
間柄|relationship, relation, terms (good, friendly, etc.)
颯と|quickly (esp. actions)
台無し|spoiled, spoilt, ruined, wasted (chance, etc.), messed up, destroyed, (coming to) nothing
申し出る|to offer, to propose, to suggest, to put forward, to request, to ask (for), to apply (for), to report (to), to notify
見せびらかす|to show off, to flaunt
面する|to face on, to look out on to
敢えて|purposely (of something needless, unexpected or seemingly counterproductive, etc.), daringly (doing something), deliberately, intentionally
玄人|expert, professional, master, connoisseur
取り扱う|to handle, to operate (a machine, etc.), to use
いい加減|irresponsible, perfunctory, careless
無邪気|innocent, simple-minded
非|fault, error, mistake
飲み込む|to swallow, to gulp down
負かす|to defeat
臆病|cowardly, timid, easily frightened
予め|beforehand, in advance, previously
詫び|apology
身なり|dress, attire, clothing, getup, outfit, personal appearance
遂げる|to accomplish, to achieve, to carry out
築く|to build, to construct, to erect
割り込む|to cut into (a line, conversation, etc.), to force oneself into (e.g. a crowd), to wedge oneself into, to squeeze oneself into, to intrude on, to interrupt
和らげる|to soften, to moderate, to relieve
お世辞|flattery, compliment
白状|confession
添える|to garnish, to accompany (as a card does a gift)
年頃|approximate age, apparent age
付け加える|to add (one thing to another), to add (a few more words, an explanation, etc.)
罵る|to abuse (verbally), to curse at, to shout abuse at, to speak ill of
遮る|"to interrupt, to obstruct (a view, someone's way, etc.), to block (light, wind, etc.), to intercept, to cut off"
温和|mild (climate), temperate, clement, pleasant, agreeable
染みる|to pierce, to penetrate, to soak in, to permeate
到底|(cannot) possibly, (not) by any means, (not) at all, utterly, absolutely
乏しい|meagre, meager, scarce, limited, destitute, hard up, lacking, scanty, poor
崇拝|worship, adoration, admiration, cult
見晴らし|view, prospect, outlook
明かす|to pass (the night), to spend
短気|short temper, quick temper, hot temper, impatience, irritability
誤魔化す|to deceive, to cheat, to swindle
微か|faint, dim, weak, slight, vague, indistinct, hazy
滑稽|funny, comical, humorous, laughable
舐める|to lick, to lap, to suck
漕ぐ|to row, to paddle, to scull, to pull (the oars)
紛失|loss, going missing
辿る|to follow (a road, path, etc.), to trace
甥|nephew
妬む|to be jealous of, to envy, to begrudge
檻|cage, pen, (jail) cell
雛|young bird, chick, fledgling
捗る|to make (good) progress, to move right ahead (with the work), to advance
辛抱|patience, endurance, perseverance
専ら|wholly, solely, entirely, exclusively, devotedly, fixedly
見落とす|to overlook, to fail to notice, to miss (seeing)
交わる|to cross, to intersect, to join, to meet
弱る|"to weaken, to grow weak, to wane, to decline (of one's health)"
矢鱈|indiscriminately, blindly, at random, recklessly, thoughtlessly, excessively, profusely
寝かせる|to put to bed, to let sleep
取りあえず|first of all, at once, right away
代わる代わる|alternately, by turns
値打ち|value, worth, merit
絶える|to die out, to peter out, to become extinct
今更|now (when it is already much too late), at this stage
鍛える|to forge, to temper
無茶|absurd, unreasonable, ridiculous
導く|to guide, to lead, to show the way, to conduct
不意|sudden, abrupt, unexpected, unforeseen
叶える|to grant (request, wish), to answer (prayer)
派|clique, group, coterie
老ける|to age, to grow old (esp. in appearance), to show marks of age
逞しい|burly, strong, sturdy
諸|various, many, several
慎む|to be careful, to be discreet
強請る|to beg, to pester, to plead, to coax, to hound, to importune
嘆く|to lament, to grieve, to regret
受け付ける|to accept, to receive (an application), to take up
携わる|to engage in, to participate in, to take part in, to be involved in
無意味|nonsense, no meaning, meaningless
凌ぐ|to endure, to keep out (e.g. rain), to stave off (e.g. starvation)
料|fee, charge, rate
超|super-, ultra-, hyper-, extreme
棘|thorn, spine, prickle
構える|to set up (a house, store, etc.), to build, to establish, to run, to maintain
傾ける|to incline, to lean, to tip, to tilt, to slant, to bend, to list
説く|to explain, to advocate, to preach, to persuade
指差す|to point at
目覚ましい|remarkable, striking, brilliant, splendid, spectacular, wonderful, conspicuous, outstanding, amazing
励む|to work hard, to try hard, to strive, to endeavour, to endeavor, to devote oneself to, to make an effort, to be zealous
旦那|master (of a house, shop, etc.)
著しい|striking, remarkable, considerable
空しい|empty, void, vacant
海抜|height above sea level
病|illness, disease
再|re-, again, repeated, deutero-, deuto-, deuter-
情け|pity, sympathy, compassion, mercy
荷作り|packing, baling, crating
重んじる|to respect, to honor, to honour, to esteem, to prize
休める|to rest, to suspend, to give relief
躾|discipline, training, teaching manners
心がける|to keep in mind, to bear in mind, to try, to aim to do, to endeavor, to endeavour
氾濫|overflowing, flood, inundation, deluge
質素|simple, plain
仰ぐ|to look up (at)
総|whole, total, gross, entire, overall, general (election, manager, etc.)
仕立てる|to tailor, to make (clothing)
密か|secret, private, surreptitious
持て成す|to treat (a guest), to receive, to entertain, to be hospitable to, to make welcome
脆い|brittle, fragile, weak, frail
背く|to run counter to, to go against, to disobey, to infringe
金槌|hammer
備え付ける|to provide, to furnish, to equip, to install
冴える|to be clear (of a sight, sound, colour, etc.), to be bright, to be vivid, to be crisp
褒美|reward, prize
使用人|employee, servant
志す|to plan, to intend, to aspire to, to set aims (sights on)
目付き|"look (in someone's eyes), expression (of the eyes), eyes"
眠たい|sleepy, drowsy
用件|business, thing to be done, something that should be performed, information that should be conveyed
聳える|to rise (of a building, mountain, etc.), to tower, to soar
弱まる|to abate, to weaken, to be emaciated, to be dejected, to be perplexed
老いる|to age, to grow old
奇数|odd number
書き取る|to write down (what someone says), to take down dictation, to take notes (e.g. of a lecture)
弾む|to spring, to bound, to bounce
顧みる|to look back on (the past), to reflect on, to reminisce about
滅びる|to go to ruin, to go under, to fall, to be destroyed, to die out, to become extinct, to perish
染まる|to be dyed
染める|to dye, to colour, to color
倹約|thrift, economy, frugality
足し算|addition
生やす|to grow, to cultivate
憧れ|yearning, longing, aspiration, adoration, admiration
繁盛|prosperity, flourishing, thriving
誇張|exaggeration
合わす|to match (rhythm, speed, etc.)
各種|every kind, all sorts
察する|to guess, to sense, to presume, to judge
繕う|to mend, to patch up, to repair, to fix, to darn
滅亡|downfall, ruin, collapse, destruction
練る|to knead, to thicken into a paste (stirring over a flame)
絡む|to twine, to get tangled, to get entangled, to get caught (in)
呟く|to mutter, to murmur, to grumble
夜更け|late at night, small hours of the morning
碌に|(not) well, (not) properly, (not) enough, (not) sufficiently, (not) satisfactorily, (not) decently
指図|directions, instructions, orders, command
尊い|precious, valuable, priceless
全快|complete recovery of health
待ち合わせ|appointment
途切れる|to break off, to come to an end, to be interrupted, to be cut short, to pause
賄う|to supply (goods, money, etc.), to cover (costs), to pay, to finance, to maintain (e.g. a family)
自惚れ|conceit, vanity, pride, self-importance, egotism
思いつき|idea, plan, fancy, impulse, thought, whim, suggestion
着飾る|to dress up
裂ける|to split, to tear, to burst, to be separated, to be divided
歩む|to walk, to go on foot
浸す|to soak, to dip, to steep, to immerse
抜かす|to omit, to leave out, to skip
大概|generally, mainly, usually, normally, mostly, for the most part
弱める|to weaken
踵|heel (of foot, shoe, stocking, etc.)
腫れる|to swell (from inflammation), to become swollen
無能|incompetence, inefficiency, inability, incapacity
汽船|steamship, steamboat, steamer
裁く|to judge, to decide, to sit in judgement, to try
欺く|to deceive, to delude, to trick, to fool
案の定|just as one thought, as usual, sure enough
取り寄せる|to order, to send away for, to have (something) sent to one
丸々|plump, rotund, chubby
余っ程|very, greatly, much, to a large extent, quite
怠い|sluggish, languid, listless, heavy (heart, legs, etc.), dull
頑丈|solid, firm, stout, burly, strong, sturdy
盛り上がる|to swell, to rise, to bulge, to be piled up
病む|to fall ill
貶す|to speak ill of, to disparage
大水|flood
丸っきり|completely, absolutely, totally, (not) at all
禁ずる|to forbid, to ban, to prohibit
欠乏|deficiency, insufficiency, shortage, lack, want, dearth, scarcity
有する|to have, to possess, to own, to be endowed with
辻褄|coherence, consistency
努めて|"as much as possible, as far as possible, to the best of one's ability, diligently"
乃至|from ... to, between ... and
組み合わせる|to put together, to combine, to join together, to join up
弁償|compensation, indemnification, reparation, restitution, recompense
嘸|surely, certainly, no doubt, must
促す|to urge, to encourage, to press, to prompt, to draw (attention to)
甘える|to behave like a spoiled child, to fawn on
長閑|tranquil, calm, quiet, peaceful, serene
明瞭|clear, plain, distinct, obvious, evident, articulate
夥しい|large number, innumerable, great many, immense, vast, abundant
食い違う|to not match well (e.g. at the seams), to not mesh properly (of gears)
自首|surrender (to the authorities), giving oneself up, turning oneself in
滲む|to run (of liquid), to spread, to bleed, to blot
鼾|snoring, snore
映える|to shine, to glow
安静|rest, quiet, repose
障る|to be harmful to, to hinder, to interfere with, to irritate
織る|to weave
善し悪し|right or wrong, good or bad, quality, suitability
若しくは|or, otherwise
操る|to operate (e.g. a machine), to handle, to manage, to control, to maneuver, to steer
脚色|dramatization (e.g. of a novel), dramatisation, adaptation (for the stage or screen)
緩める|to loosen, to slacken
栄える|to prosper, to flourish
恵む|to bless, to show mercy to
恋する|to fall in love (with), to love
不吉|ominous, sinister, unlucky, inauspicious
先天的|inborn, innate, inherent, congenital, hereditary
遠ざかる|to go away, to become more distant, to fade away, to die away
未開|uncivilized, uncivilised, primitive, savage
月並み|every month
没落|ruin, fall, collapse, downfall, bankruptcy
取り巻く|to surround, to encircle, to enclose
月賦|monthly installment (instalment), monthly payment
只管|"intently, single-mindedly, devotedly, solely, earnestly, with all one's heart"
綻びる|to come apart at the seams, to be ripped, to be torn
嫌らしい|unpleasant, disagreeable, nasty
取り締まる|to manage, to control, to supervise, to oversee, to command
仮|temporary, provisional, interim, tentative
馴れ馴れしい|overly familiar, overfamiliar, too friendly, too free, cheeky
重宝|convenient, useful, handy, helpful
賑わう|to be crowded with people, to be bustling with
雑|rough, crude, sloppy, messy
公|official, governmental, formal
途絶える|to stop, to cease, to come to an end, to cut off
慕う|to yearn for, to long for, to pine for, to miss, to love dearly, to adore
揉める|to disagree, to dispute, to fight (over)
観|look, appearance
乱す|to throw into disorder, to disarrange, to disturb (order, peace, etc.), to corrupt (public morals), to dishevel (hair)
冷やかす|to banter, to make fun of, to jeer at
共稼ぎ|(husband and wife) earning a living together
研ぐ|to sharpen, to hone, to whet, to grind
強まる|to get strong, to gain strength
悉く|altogether, entirely
吟味|close examination, careful investigation, close inspection, careful selection, inquiry, enquiry, scrutiny, testing
引っ掛ける|to hang (something) on (something), to throw on (clothes)
雨具|rain gear
逸らす|"to turn away (one's eyes, face, etc.), to avert, to divert (e.g. one's attention), to evade (e.g. a question), to change (e.g. the subject)"
面皰|pimple, acne
沈める|to sink (e.g. a ship), to submerge
平方|square (e.g. metre)
仕入れる|to lay in stock, to replenish stock, to procure
貴ぶ|to value, to prize, to esteem
差し掛かる|to come near (to), to approach
綴じる|to bind, to file
束縛|restraint, restriction, fetters, yoke, shackles
同|the same, the said
目盛り|gradations (on a ruler, thermometer, etc.), division, scale
煩わしい|troublesome, annoying, complicated
平たい|flat, even, level
目方|weight
悪者|bad guy, villain, evildoer, scoundrel
予て|previously, already, for some time, for quite a while
垢|dirt, filth, grime
履歴|personal history, background, career
率いる|to lead, to spearhead (a group), to command (troops)
冷酷|cruelty, coldheartedness, relentless, ruthless
鈍感|thickheaded, insensitive, dull, thick-skinned
手遅れ|"being too late, losing one's final chance"
懲りる|"to learn by experience, to learn one's lesson, to learn the hard way"
安っぽい|cheap-looking, tawdry, insignificant
心強い|heartening, reassuring
整列|standing in a row, forming a line, alignment
陰気|gloomy, dismal, miserable, melancholy
月謝|monthly tuition fee
健やか|vigorous, healthy, sound
煙たい|smoky
賛美|praise, glorification, extolment
荒っぽい|wild, violent, rough-mannered, rude
原書|original document (not a copy or adaptation), book in its original language (esp. a European language)
着席|"taking a seat, sitting down (in one's seat)"
嘴|beak, bill
急かす|to hurry (up), to urge on, to press, to rush
布巾|dish towel, tea towel, dishcloth
化ける|to take the form of (esp. in ref. to a spirit, fox, raccoon dog, etc.), to assume the shape of, to turn oneself into, to transform oneself into
真心|sincerity, true heart, devotion
打ち合わせる|to knock together, to strike against each other
突如|suddenly, all of a sudden, unexpectedly
何卒|please, kindly, I beg of you, if it pleases you
代弁|speaking by proxy, speaking for (someone else), acting as spokesman (for), representing (the views, feelings, etc. of)
物足りない|unsatisfied, unsatisfactory, insufficient
適宜|suitable, appropriate, fitting, proper
頬っぺた|cheek
無闇に|thoughtlessly, recklessly, rashly, indiscriminately, indiscreetly, at random
無茶苦茶|nonsensical, unreasonable, absurd, unrealistic
夜具|bedding, bedclothes
次いで|next, secondly, subsequently
碌な|satisfactory, decent, good, proper, respectable
主観|subjectivity, subject (philosophical), ego
漏る|to leak, to run out
見苦しい|unsightly, ugly, unseemly, indecent, deplorable, disgraceful, shameful
手分け|division of labour, division of labor, splitting into groups (e.g. to search)
弱|a little less than, a little under, slightly fewer than
下調べ|preliminary investigation, preliminary inquiry
改まる|to be renewed, to change
持てる|to be able to possess (hold, get, etc.)
清々しい|refreshing (e.g. feeling, scene, wind, morning air), brisk, bracing, fresh, refreshed
私用|personal use, private use
心細い|helpless, forlorn, hopeless, unpromising, lonely, discouraging, disheartening
年長|senior, older
葬る|to bury, to inter, to entomb
担う|"to carry on one's shoulder, to shoulder, to bear"
近眼|nearsightedness, shortsightedness, myopia
裾|hem, (trouser) cuff, shirttail, bottom (of a kimono), train (of a dress)
満場|whole house, whole audience
延べ|futures
厳か|solemn (ceremony, atmosphere, etc.), austere, grave, majestic, dignified, stately, impressive
姓名|(full) name, family name and given name
Ｇパン|jeans, dungarees
生臭い|smelling of fish, fishy, smelling of blood, bloody
彼の|that, those, the
カ月|counter for months
嗚呼|ah!, oh!, alas!
第|prefix for forming ordinal numbers
見かける|to (happen to) see, to notice, to catch sight of
御座います|to be, to exist
怯える|to become frightened, to be frightened (of), to be scared (of)
たどり着く|"to (finally) arrive at, to reach (at last), to (manage to) get to, to find one's way to"
傷つく|to be wounded, to get injured
且つ|and, moreover, besides, as well as, and on top of that, at the same time
即座に|immediately, right away, on the spot
出社|going to work (e.g. in the morning), coming to work
若しかして|"perhaps, possibly, maybe, by any chance, if I'm not mistaken"
お使い|errand, mission, going on an errand
一息|one breath
赴く|to go in the direction of, to proceed toward, to proceed according to, to repair to, to betake oneself to
何だかんだ|something or other, one thing or another, this or that
司る|to be in charge of, to manage, to direct, to administer, to preside over
お襁褓|diaper, nappy
微塵|particle, atom, little piece
申し分|objection, shortcomings
粉々|in very small pieces
逃す|to miss (e.g. a chance), to lose, to let get away
出くわす|to happen to meet, to come across, to run into, to bump into
結び付ける|to tie (to), to fasten, to attach, to join, to bind
小銭|small change, coins
仕える|to serve, to work for, to attend
善良|good (person, nature, etc.), good-natured, virtuous, honest
長々|for a long time, at (great) length, lengthily, long-windedly, tediously
上回る|to exceed (esp. figures: profits, unemployment rate, etc.), to surpass, to be more than, to be better than
素っ気ない|cold, short, curt, blunt
産出|production, output, turning out
給仕|waiting on a table, serving (at dinner)
滅ぼす|to destroy, to overthrow, to wreck, to ruin
教職|the teaching profession
同い年|the same age
挑む|to challenge to (a fight, game, etc.), to throw down the gauntlet, to contend for
勘弁|pardon, forgiveness, forbearance
朝寝坊|sleeping late in the morning, sleeping in, lie-in, oversleeping
押し寄せる|to advance on, to close in, to march on, to descend on (the enemy), to move towards, to surge forward (crowd, wave of nostalgia, wave, etc.), to rush for (the door), to inundate, to overwhelm, to push aside
拝借|borrowing
片付け|tidying up, finishing
幾多|many, numerous
生ける|to arrange (flowers), to plant
整然|orderly, regular, systematic, well-organized, well-organised, trim, tidy, accurate
期|period, time
召す|to call, to summon, to send for, to invite
昼飯|lunch, midday meal
口述|dictation, verbal statement
用法|directions, rules of use
痛切|keen, acute, heartfelt
初耳|something heard for the first time, hearing something for the first time
大柄|large build
原典|original (text)
下取り|trade-in, part exchange
下心|secret intention, ulterior motive
首輪|(animal) collar
産休|maternity leave, paternity leave
西日|westering sun, setting sun, afternoon sun
海路|sea route
案じる|to be anxious (about), to be concerned (about), to worry (about), to fear
手近|near, close by, within reach, handy
滞る|to stagnate, to be delayed, to be left undone
家来|retainer, retinue, servant
語句|words and phrases, words
遠回り|detour, roundabout way
概略|outline, summary, gist, in brief
隔たる|to be distant
片言|prattle, broken language, halting language, baby talk, imperfect speech, smattering
甘口|sweet flavour, sweet flavor, mildness
仕切る|to partition, to divide, to mark off
窮乏|poverty, destitution, privation, indigence, penury
決行|doing (with resolve), carrying out (e.g. a plan)
転校|changing schools
回覧|circulation (esp. documents), sending round
宙返り|somersault, looping-the-loop
口ずさむ|to hum (a tune), to sing to oneself, to croon
統率|command, lead, generalship, leadership
記名|signature, register
潜入|infiltration, sneaking in, going undercover
悩ましい|seductive, carnal, enchanting
高尚|high, noble, refined, advanced
封建|feudalistic
山腹|hillside, mountainside
残金|remaining money
優越|supremacy, predominance, being superior to
取り調べる|to investigate, to examine
取り立てる|to collect (debts), to dun, to exact, to extort
気品|elegance, refinement, grace, dignity
首飾り|necklace, choker
気流|atmospheric current, air current, airflow
愛憎|love and hate
澄ます|to clear, to make clear
伝来|introduction (from abroad)
継ぎ目|joint, seam, joining point
兼用|multi-use, combined use, combination, serving two purposes
生身|living flesh, flesh and blood
然しながら|however, nevertheless
囀る|to sing, to chirp, to twitter
見窄らしい|shabby, unsightly, unkempt, seedy
寄り掛かる|to lean against, to recline on, to lean on
掻き回す|to stir, to churn, to poke (a fire), to disturb (water)
煽てる|to flatter, to soft-soap, to sweet talk, to cajole, to instigate
誂える|to give an order, to place an order, to have made to order
捩れる|to get twisted, to get crooked, to get warped
難い|difficult, hard
なんか|something like ..., things like ..., someone like ..., the likes of ...
くらい|approximately, about, around, or so
オレンジ|orange (fruit, colour)
セール|sale
アンコール|encore
タイマー|timer, time switch
ソロ|solo
天井|ceiling
世論|public opinion, popular voice, public sentiment, consensus
日向|sunny place, in the sun
降伏|surrender, capitulation, submission
乳|milk
酸|acid
自尊心|self-esteem, self-respect, self-importance, conceit, pride
雄|male (animal, plant)
骨董品|curio, antique
焚き火|open-air fire (e.g. for garden refuse), bonfire
獣|beast, brute, animal
腸|guts, bowels, intestines
周|counter for laps or circuits
接続詞|conjunction
自動詞|intransitive verb
修飾|ornamentation, embellishment, decoration, adornment
蒸留|distillation
他動詞|transitive verb
ショック|shock (emotional)
ロープ|rope
データ|data, datum
サイズ|size
デザイン|design
システム|system
カンニング|cheating (on an examination), cribbing
ジャズ|jazz
コンテスト|contest
ファン|fan, enthusiast, lover (of)
ストレス|stress
タイヤ|tire, tyre
デザート|dessert
ビジネス|business
ストライキ|strike (i.e. industrial action)
ポット|pot (esp. teapot, coffee-pot)
コミュニケーション|communication
街|street, quarter, district, area
ジャンプ|jump
ウイルス|virus
メロディー|melody
パジャマ|pajamas, pyjamas
コーナー|corner, bend, turn
アンケート|questionnaire, survey, poll
タイミング|timing
アマチュア|amateur
ブーム|boom, rage, fad
パチンコ|pachinko, mechanical gambling game superficially resembling pinball
フロント|front (aspect, weather, war-front, etc.)
クイズ|quiz
オープン|opening (a new store, golf course, runway, etc.)
レギュラー|regular, standard
ダウン|fall, decrease, drop, going down
ドライ|dry
タレント|(TV or radio) entertainer, television personality, radio personality
グラフ|graph, chart, diagram
スタジオ|studio
ノイローゼ|neurosis, nervous breakdown, mental problem, identity crisis, obsession
ムード|mood, atmosphere
和|sum
アルカリ|alkali
バッジ|badge
ワット|watt
インテリ|intellectual, educated person
柵|fence, paling, railing
カテゴリー|category
ドライバー|driver (of a vehicle)
コメント|comment
ナプキン|(table) napkin, serviette
ブーツ|boots
ポイント|point (of a story, argument, etc.), important part, vital point
フェリー|ferry
スペース|space, room
サンタクロース|Santa Claus
スポーツカー|sports car
ベストセラー|bestseller
コンタクト|contact
レンタカー|rental car, rent-a-car, hire car, hired car
ラベル|label
ナイター|game under lights (e.g. baseball), night game
ゼリー|jello, jelly, gelatin dessert
カクテル|cocktail
トランジスタ|electrical transistor
デモンストレーション|demonstration, protest
キャッチ|catch, catching, obtaining (e.g. information), receiving (e.g. radio transmission or phone call)
ポンプ|pump
コンパス|pair of compasses, compass (for drawing circles, etc.)
オンライン|online
ストロー|drinking straw
モニター|monitor (device, software or person), monitoring
チャイム|chime, bell (e.g. doorbell)
デッサン|rough sketch
ホース|hose
ポジション|position
ボイコット|boycott
コントラスト|contrast
サイクル|cycle
タイル|tile
クレーン|crane (machine)
ジャンル|genre, category, kind
大部|lengthy (of a book, etc.), voluminous
樹木|tree, trees and shrubs
酪農|dairy farming
土俵|(wrestling) ring
ショー|show, performance
バー|bar, tavern, saloon, barroom
グレー|grey, gray
カルテ|"patient's chart, clinical records"
大金|large amount of money, great cost
戦|war, battle, campaign, fight
一目|glance, look, glimpse
遣り遂げる|to accomplish, to finish, to carry through, to follow through
類い|kind, sort, type
行|line (of text), row, verse
正しく|certainly, surely, undoubtedly, evidently, really, truly
ずぶ濡れ|dripping wet, soaked, drenched
恥|shame, embarrassment, disgrace
高|quantity, amount, volume, number, amount of money
遅くとも|at the latest
早急|immediate, prompt, quick, rapid, urgent, pressing
あざ笑う|to laugh at, to ridicule, to mock, to make fun of, to sneer at
作り|making, producing, manufacturing, building, construction, make, structure
新入生|new student, freshman, first-year student
廃れる|to go out of use, to become obsolete, to die out, to go out of fashion, to go out of style
引っ掻く|to scratch, to claw
相応|suitable, appropriate, befitting, becoming, adequate, reasonable, proper
其処ら|everywhere, somewhere, approximately, that area, around there
沿い|along (a river, coast, railway, etc.), on (e.g. a street)
放り出す|to throw out
お供|attendant, companion
故|the late, the deceased
先に|previously, before, earlier, formerly, recently
震わせる|to (make something) quiver, to shake, to tremble, to vibrate
呆然|dumbfounded, overcome with surprise, in blank amazement, in a daze
仕来たり|custom, convention, tradition, mores, conventional practice
諦め|resignation, acceptance, consolation
悪どい|gaudy, showy, garish, loud
花弁|(flower) petal
校|school
呆気ない|unsatisfying, disappointing, abrupt, not enough, too quick, too short, over too soon
給う|to give
然程|(not) so, (not) particularly, (not) very, (not) that much
つり革|strap (to hang onto), hanging strap
気立て|disposition, nature
蹴飛ばす|to kick away, to kick off, to kick hard
濯ぐ|to rinse, to wash out
真ん前|right in front, just opposite, under the nose
嵩張る|to be bulky, to be unwieldy, to grow voluminous
盛装|"dressing up in fine clothes, splendid clothes, one's best clothes"
郷里|hometown, birthplace
中程|(about) middle, midway
腹立ち|anger
馬鹿馬鹿しい|absurd, ridiculous, silly, ludicrous, nonsensical, asinine, foolish
涸れる|to dry up (spring, pond, etc.), to run out
何なり|anything, whatever
恐れ入る|to be sorry, to beg pardon, to be much obliged, to feel small
嫌々|unwillingly, grudgingly, reluctantly
掌|palm (of the hand)
目論見|plan, scheme, plot, design, project, intention, aim
勤まる|"to be fit (for a role), to be qualified (for), to be equal (to a task), to be able to fulfill one's duties (as)"
接ぐ|to join, to piece together, to set (bones)
因って|therefore, consequently, accordingly, for that reason
放り込む|to throw into, to toss into
助動詞|inflecting dependent word (in Japanese), bound auxiliary
噛み切る|to bite off, to gnaw through
諸に|completely, all the way, altogether, bodily
貫禄|presence, dignity
煌々|brilliant, bright, dazzling
軋む|to jar, to creak, to grate
瞬き|blink (of eyes), wink
植わる|to be planted
心中|"double suicide, lovers' suicide"
警部|police inspector
言伝|(oral) message, declaration, hearsay, rumour, rumor
供する|to offer, to present, to submit, to supply, to make available
抓る|to pinch, to nip
圏|sphere, circle, range, area, zone, bloc
細工|work, workmanship, craftsmanship, handiwork
介抱|nursing, looking after
高原|tableland, plateau
合わせ|joint together, opposite, facing
相対|involving only the parties concerned, tete-a-tete
生真面目|overserious, deeply sincere, very earnest
差し引く|to deduct, to take away, to dock, to discount
賜る|to be given, to be granted, to be honored with, to be honoured with
辟易|to be fed up (with), to be tired (of), to be bored (with), to be unable to bear
咄嗟|moment, instant
毟る|to pluck, to pick, to tear
宛てる|to address
湿気る|to get damp, to get moist, to get soggy, to become humid
照り返す|to reflect, to throw back light
朽ちる|to rot, to decay
手筈|arrangements, plan, programme, program, preparations
問|counter for questions
纏まり|unity, coherence, consistency, coordination, order
鉄片|iron scraps
帳|curtain, hanging, bunting
対辺|opposite side
駄作|poor piece of work, rubbish, trash
赤らむ|to become red, to redden, to blush
虚ろ|cavity, hollow, void
嵩む|to mount up, to pile up, to accumulate, to increase
お宮|Shinto shrine
汚らわしい|filthy, unfair, dirty, untouchable, disgusting, nasty, foul, odious, repulsive
比重|specific gravity, relative density
治安|public order, public peace, public security, law and order
仲人|matchmaker
配列|arrangement, disposition
飽和|saturation, satiation
渡り鳥|migratory bird, bird of passage
動員|mobilization, mobilisation
特許|patent
振動|oscillation, vibration, swing (e.g. of a pendulum)
考古学|archaeology, archeology
暦|calendar, almanac
鉱業|mining industry
版画|woodcut, woodblock print, art print
元首|sovereign, ruler, head of state
断面|section, cross section, profile
標語|motto, slogan, catchword
分業|division of labor, division of labour, specialization, specialisation, assembly-line production
分散|dispersion, breakup, scattering, decentralization, decentralisation, distribution
文化財|cultural assets, cultural property
革新|reform, innovation
極楽|"Sukhavati (Amitabha's Pure Land)"
桟橋|wharf, bridge, jetty, pier
学士|university graduate, bachelor
司法|administration of justice, judicature
密度|density
持続|continuation, persisting, lasting, sustaining, enduring
立体|solid body, three-dimensional object
林業|forestry
歯科|dentistry
畜産|animal husbandry, livestock industry
領海|territorial waters
渦|whirlpool, swirl, eddy, vortex, maelstrom
軍服|military uniform
肥料|manure, fertilizer, fertiliser, compost
さん|Mr., Mrs., Miss, Ms., -san
留める|to stop, to stay (e.g. the night), to cease, to put an end to
にも関わらず|in spite of, nevertheless, although, despite, no matter the, regardless of
第一|first, foremost, number one
どうにか|in some way or other, one way or another, somehow, only just, barely
スピード|speed
だらけ|full of (e.g. mistakes), riddled with
ルール|rule
きっぱり|clearly, plainly, distinctly, decisively, flatly, definitely, resolutely
どうやら|possibly, apparently, (seem) likely, seemingly
しょっちゅう|always, all the time, constantly, frequently, often
インフレ|inflation
カーペット|carpet
万人|all people, everybody
ぶらぶら|dangling, swaying, swinging
センス|taste (in fashion, music, etc.), sense (e.g. of humour), flair
じっくり|(slowly and) carefully, without haste, thoroughly, deliberately, closely, meticulously
サボる|to be truant, to slack off, to play hooky, to skip school, to cut class, to skip out
打|dozen
捲る|to turn up, to roll up (e.g. sleeves)
室|room
突く|to poke (repeatedly, lightly), to nudge
ガイド|guide, tour guide, conductor, guiding, leading
焦る|to be in a hurry, to be impatient, to be anxious (to do), to fret
メッセージ|message
毎|each, every
拘わる|to be obsessive (about), to be overly concerned (with), to fuss (over), to worry too much (about), to be picky (about), to be hung up (on), to stick to
授ける|to grant, to give, to confer, to award
あら|oh!, ah!, oh no
チャネル|channel
ロマンチック|romantic
トラブル|trouble, difficulty, problem, quarrel, conflict, dispute, fight
タワー|tower
メーカー|manufacturer (esp. a major company), producer, maker
マスコミ|mass communication, mass media
一重|one layer, single layer
垂れる|to hang, to droop, to dangle, to sag, to lower, to pull down
紛れる|to disappear into, to be lost in, to slip into, to get mixed in among
ガレージ|garage
セックス|sex, sexual intercourse
ゆとり|elbowroom, leeway, room, reserve, margin, allowance, latitude, time (to spare)
露|dew
あっさり|easily, readily, quickly, flatly (refuse)
パトカー|patrol car, police car, squad car, cruiser
ヒント|hint, clue
カメラマン|photographer
しくじる|to fail, to blunder, to mess up, to screw up
だぶだぶ|loose (of clothing), baggy
跨る|to straddle, to sit astride, to mount
ずばり|decisively, decidedly, boldly, once and for all, unreservedly, frankly
メディア|media
タイム|time (for, to do)
藻掻く|to struggle, to writhe, to wriggle, to squirm
レントゲン|X-ray
おどおど|timidly, nervously, hesitantly, trembling (with fear), fearfully, anxiously
弄る|to finger, to touch, to play with, to fiddle with, to toy with
疎か|negligent, neglectful, careless, remiss
ずれる|to slide, to slip off, to get dislocated, to be out of alignment, to get dislodged, to deviate, to shift (position), to be out of sync, to be slightly off, to be off-point
ぺこぺこ|very hungry, starving, famished
区々|various, diverse, different, divergent, divided, conflicting
びっしょり|wet through, drenched
ややこしい|complicated, complex, intricate, confusing, difficult, troublesome
アップ|rise, increase, raising, lifting, going up
ニュアンス|nuance
マーク|mark, symbol, insignia, logo, label, emblem
コマーシャル|commercial (TV or radio advertisement)
シナリオ|script, screenplay
がっちり|solid, robust, well-built
きっちり|exactly, precisely, punctually, on the dot
ずるずる|(dragging a large or heavy item) slowly
がっしり|firmly, solidly, sturdily, strongly, toughly
ぞんざい|rough, careless, slovenly, slipshod, rude, impolite
埋まる|to be buried, to be covered, to be surrounded
歪む|to warp, to bend, to contort
ミスプリント|misprint
ミュージック|music
気障|affected, smug, pompous, conceited, snobby, pretentious
でかい|huge, big, gargantuan
労る|to pity, to sympathize with, to sympathise with, to treat with sympathy, to console, to be kind to
アルミ|aluminum, aluminium
丁目|district of a town, city block (of irregular size)
てっきり|surely, certainly, without doubt
ばてる|to be exhausted, to be worn out
ちょくちょく|often, frequently, now and then, occasionally
とんだ|unexpected, unlikely, strange
ぼやける|to become dim, to become blurred
股|thigh
あやふや|uncertain, indefinite, vague, ambiguous, equivocal, dubious, doubtful, non-committal
蛋白質|protein
漢語|Japanese word of Chinese origin, Sino-Japanese word
梅干し|umeboshi, pickled dried ume, pickled dried plum
縁側|engawa, external corridor on the outer side of traditional Japanese houses
発芽|germination, sprouting, budding
文語|written language, literary language
屈折|bending, curving, twisting, turning, winding
盲点|blind spot (on the retina)
仮令|even if, no matter (what), if, though, although, supposing, supposing that, -ever
冬眠|hibernation, winter sleep, torpor
ちり取り|dustpan
修行|training, practice, discipline, study
類推|analogy
うんざり|tedious, boring, being fed up with
ほっと|with a feeling of relief, with a sigh of relief
おおい|hey!, say!, I say!, come on!, look!, oi!
共|together with
ＯＫ|OK, okay
ちらっと|at a glance, by accident
嵌まる|to fit, to get into, to go into, to be fitted with (e.g. door with a window)
がっくり|heartbroken, crestfallen, dejected, disappointed
ばら撒く|to scatter, to disseminate (e.g. a rumor), to spread (e.g. germs), to broadcast
くっきり|clearly (standing out), distinctly, sharply, boldly, in sharp relief
がる|to show signs of being, to feel, to think
卯|the Rabbit (fourth sign of the Chinese zodiac), the Hare
消去|erasure, deletion, elimination, clearing
ファイル|file (for holding papers)
レッスン|lesson
ブルー|blue
ガイドブック|guidebook
タイピスト|typist
アプローチ|approach (to a problem, issue, etc.)
コントロール|control
エンジニア|engineer
ユニーク|unique, individual, original, unusual
ナンセンス|nonsense
ユニフォーム|uniform
ソックス|socks
ハンガー|(aircraft) hangar
ブザー|buzzer, personal alarm (loud buzzer to attract attention in case of attack)
セクション|section
レバー|liver
ニュー|new
タイトル|title
チームワーク|teamwork
アラブ|Arab
インフォメーション|information
ストロボ|stroboscope, strobe lamp, stroboscopic lamp
ファイト|fight
オリエンテーション|orientation
ライス|rice (esp. when served on a plate)
ゲスト|guest
スチーム|steam
スラックス|slacks
テレックス|telex, teletypewriter exchange
免れる|to escape (disaster, death, etc.), to be saved from, to be rescued from
泊|counter for nights of a stay
鈍る|to become blunt, to grow dull
化する|to change (into), to turn (into), to transform (into), to become
真下|right under, directly below
短波|short wave
碁盤|Go board
字体|form of a character (e.g. simplified, traditional)
磁器|porcelain, china, chinaware
回送|forwarding, sending on, redirecting (e.g. mail)
退化|degeneration, retrogression, atrophy
球根|(plant) bulb
失調|lack of harmony, lack of balance, lack of coordination, malfunction
庁|government office, agency, board
社宅|"company housing, housing provided by one's company"
新興|rising, developing, emergent, burgeoning, new
箇|counter used with Sino-Japanese words
汚れ|uncleanness, impurity, defilement
モーテル|motel
ドライブイン|drive-in (bank, cinema, etc.)
ホット|hot
ドライクリーニング|dry cleaning
インターフォン|intercom, interphone
愚痴|idle complaint, grumble
固める|to harden, to freeze, to strengthen, to solidify, to make (a fist), to tramp down (snow, dirt)
断つ|to sever, to cut off
不振|dullness, slump, stagnation, inactivity, depression
施行|putting in force (a law), putting into operation, putting into effect, enforcement
難|difficulty, trouble, hardship, shortage
幹部|management, (executive) staff, leaders, leadership, top brass, upper echelons
巻|roll (e.g. of cloth)
守備|defense, defence
演ずる|to act (a part), to play (a role)
採掘|mining, digging, working (a mine)
中継|relay, hook-up
幹|(tree) trunk, (arrow) shaft, (tool) handle, backbone, base
自主|independence, autonomy, self-reliance
短歌|tanka, 31-mora Japanese poem
短大|junior college, vocationally oriented two or three year post-secondary education institution
一様|uniform, equal, even, the same, identical
弾力|elasticity, flexibility
控え室|waiting room, anteroom, antechamber, green room
着目|"attention, giving one's attention, focusing"
抽選|lottery, raffle, drawing (of lots)
準ずる|to follow (a rule, precedent, etc.), to conform to (the law, standards, etc.), to be based on, to apply correspondingly
壇|platform, podium, rostrum, pulpit
閲覧|inspection, reading, perusal
特産|being produced in a particular region, local specialty
土木|engineering works, civil engineering, public works
科|department, section, faculty, school, arm
隔週|every other week, every two weeks
必然|inevitable, necessary, certain, sure
過疎|underpopulation, low population density, depopulation
同級|the same grade, same class
公募|public appeal (e.g. for contributions), public advertisement (of a post), open recruitment
独創|originality
感度|sensitivity (e.g. of a measuring instrument), reception (radio, TV, etc.)
発病|onset of an illness, falling ill
一気|one breath
転居|moving, changing residence, change of address
改修|repair, improvement
改定|revision (of a rule, price, etc.), alteration, change
国交|diplomatic relations
元年|first year (of an imperial era)
区切り|pause (in speech, writing, etc.), punctuation
微量|minuscule amount, extremely small quantity
実費|actual expenses, out-of-pocket expenses
座談会|symposium, round-table discussion
桐|paulownia (Paulownia tomentosa), empress tree, foxglove tree
国有|national ownership, state ownership, government ownership
保母|(female) childcare worker, kindergarten teacher
赴任|moving to a different location to start a new job, (proceeding to) new appointment
殿様|nobleman, dignitary, lord
模索|groping (for), fumbling around (for), searching (for an answer, solution, etc.), trying to find
複合|composite, combined, complex
財源|source of funds, resources, finances
慣例|custom, practice, convention, precedent
演習|practice, exercise, drill
保温|retaining warmth, keeping heat in, heat insulation
橋渡し|mediation, good offices, go-between, intermediary, mediator, bridge (between)
保養|health preservation, recuperation, recreation
手際|skill, ability, dexterity
倍率|magnification, leverage, amplification, scaling factor, scale factor
産婦人科|maternity and gynaecology department (gynecology), department of obstetrics and gynaecology (gynecology)
民主|democracy, popular sovereignty
共和|republicanism
還暦|"kanreki, one's 60th birthday (or 61st in the traditional age reckoning system) when one has lived through a full sexagenary cycle"
刊行|publication, issue
本名|real name
興業|promotion of industry, inauguration of a new industrial enterprise
麻|cannabis (Cannabis sativa), hemp (plant)
幹線|main line, trunk line
私有|private ownership
過多|excess, surplus, superabundance
一律|uniform, even, across-the-board, equal
簡易|simplicity, convenience, easiness, quasi-
有機|organic
遊牧|nomadism
商|quotient
季刊|quarterly publication
質疑|question
公認|official recognition, official approval, certification, authorization, authorisation
眼科|ophthalmology
軽減|abatement, reduction
主導|leadership, initiative, spearhead
翔る|to soar, to fly
感慨|deep emotion, strong feelings
先代|"previous generation (of a family), previous head of the family, one's (late) father"
茶の間|(Japanese-style) living room
合議|consultation, conference, discussion, counsel
農耕|farming, agriculture, cultivation
異動|(personnel) change, transfer, relocation, reassignment, reshuffle
漠然|vague, obscure, indistinct, hazy, ambiguous
周期|cycle, period
膜|membrane, film
規格|standard, norm
就業|employment, starting work
衆|great numbers (of people), numerical superiority, masses
住|dwelling, living
共存|coexistence
起点|starting point, origin
起伏|undulation
祝賀|celebration, congratulations
対面|meeting face-to-face, seeing in person
保育|nurturing, rearing, childcare, day care
議事堂|assembly hall, parliament house, diet building, capitol, houses of parliament, congress hall
威力|power, might, authority, influence
手引|guidance, lead, acting as guide, giving assistance
小児科|pediatrics
喫茶|tea drinking
客観|objectivity, objective, object (philosophical)
域外|outside the area
信任|trust, confidence, credence
普遍|universal, general, ubiquitous, omnipresent
漁村|fishing village
一心|one mind
共学|coeducation
共産|communism
納入|payment (of taxes, fees, etc.)
真っ二つ|in two equal parts
役場|town hall
教習|training, instruction
和風|Japanese style
平常|normal, usual, ordinary, everyday
印鑑|stamp, seal
水田|(water-filled) paddy field
正規|regular, normal, formal, legal, established, legitimate
生計|livelihood, living
横綱|yokozuna (highest rank in sumo), grand champion
独裁|dictatorship, despotism, autocracy
親善|friendship, goodwill, friendly relations, amity
折衷|compromise, cross, blending, eclecticism
専修|specialization, specialisation
戦災|war damage
了|finish, completion, the end
経る|to pass, to elapse, to go by
本格|original method, original procedure, genuine way (of doing something)
膳|small dining table (usu. for a single person), serving tray (with legs)
無念|regret, chagrin, mortification
先着|arriving first
結び|ending, conclusion
結びつき|connection, relation
英字|English letter, alphabetic character
結束|union, unity, solidarity
蔵相|Minister of Finance
聞き取り|listening comprehension, aural comprehension
妥結|settlement, an agreement
加味|seasoning, flavoring, flavouring
徴収|collection (of fees, taxes, etc.), levy
水気|water content, moisture, juiciness, dampness
筒|pipe, tube, cylinder
添う|to meet (wishes, expectations, etc.), to satisfy, to comply with, to live up to
乗っ取る|to take over, to capture, to seize, to commandeer, to occupy, to usurp
差し支える|to interfere (with), to hinder, to be hindered (from doing), to become impeded, to have difficulty, to suffer inconvenience
連ねる|to line up, to put in a row
和やか|mild, calm, gentle, quiet, congenial, amicable, amiable, friendly, genial, harmonious, peaceful
心がけ|(mental) attitude, way of thinking, attention, care, prudence, intention
並列|arranging in a line, standing in a row
軒並み|row of houses
弛む|to slacken, to loosen, to relax, to droop (e.g. loose or flabby skin), to sag (ceiling)
着色|colouring, coloring, colorant
化合|chemical combination
年輪|annual tree ring, growth ring
水洗|washing with water, rinsing, flushing
纏め|settlement, conclusion, summary
華々しい|brilliant, splendid, glorious, magnificent, spectacular
長大|long and large, tall and large, grand, huge
特技|special skill
耳鼻科|otolaryngology, ear, nose, and throat department
明くる|next (day, morning, etc.), following
粘る|to be sticky, to be adhesive
雅致|artistry, good taste, elegance, grace
拝啓|Dear (so and so), Dear Sir, Dear Madam, To Whom It May Concern
化繊|synthetic fiber, synthetic fibre, chemical fiber, chemical fibre
突っ張る|to cramp up, to tighten, to stiffen
以て|with, by, by means of
点火|ignition, lighting, firing, setting off
敬具|yours sincerely, sincerely yours, yours truly
紛らわしい|easily mixed up (e.g. similar words), easily mistaken, confusing, misleading, equivocal, ambiguous
年号|name of an imperial era (e.g. Heisei, Shōwa), Japanese era name
減点|subtracting points
縮まる|to shorten, to narrow, to close, to shrink
分母|denominator
遅らす|to delay, to postpone, to slow down, to retard
状|form, shape, appearance
緩む|to become loose, to slacken (e.g. rope)
よそ見|looking away, looking aside
帰京|returning (home) to Tokyo, returning to the capital
ばい菌|germ, germs, bacteria, bug
冷蔵|cold storage, refrigeration
擽ったい|ticklish
婉曲|euphemistic, circumlocutory, roundabout, indirect
行き違い|crossing without meeting (e.g. letters in the post, people on the road), going astray
籤引き|lottery, drawn lot
殊に|especially, particularly, unusually, above all
薄弱|feebleness, weakness, weak
清らか|clean, clear
折り返す|to turn up (hem, sleeves, etc.), to fold back (e.g. page)
取り次ぐ|to pass on (a message, thoughts, etc.), to convey, to transmit, to relay, to tell
煌びやか|gorgeous, gaudy, dazzling, gay, resplendent
重んずる|to honor, to honour, to respect, to esteem, to prize
準急|semi-express train, local express train, sub-express train
掬う|to scoop, to ladle out
打ち消し|negation, denial, negative
休学|temporary absence from school
付録|appendix, supplement, annex, extra (of a newspaper or magazine)
民俗|folk customs, folkways, ethnic customs
養護|nursing, (protective) care
一挙に|at a stroke, with a single swoop
洋風|Western style
婿|husband, groom
潤う|to become moist, to be moistened, to become damp, to get wet
駆け足|running fast, double time
連なる|to extend, to stretch out, to stand in a row
担架|stretcher, litter (medical), gurney
切ない|painful, heartrending, trying
気兼ね|constraint, reserve, feeling hesitant, being afraid of troubling someone
縁談|marriage proposal, marriage talks
物好き|(idle) curiosity, fancifulness, whimsy, (having) strange tastes
錯誤|mistake, error, discrepancy
生ぬるい|lukewarm, tepid
原っぱ|open field, empty lot, plain
嗜好|taste, liking, preference
云々|and so on, and so forth, et cetera, and such, and the like
伊|Italy
切り替える|to change, to exchange, to convert, to renew, to throw a switch, to replace, to switch over
恥じらう|to feel shy, to be bashful, to blush
旧知|old friend, old acquaintance
慣用|customary use, common usage, general usage
華美|splendor, splendour, gorgeousness, pomp, magnificence
転任|change of post
兼業|"perusing as a side business, doing in addition to one's main work, running (businesses) simultaneously"
等級|grade, class, degree, rank, rating, order, points
果てる|to end, to be finished, to be exhausted
動的|dynamic, kinetic
課外|extracurricular
跡継ぎ|heir, inheritor
他意|other intention, hidden purpose, ulterior motive, ill will, malice
反り|warp, curvature, curve, arch
余興|performance (at a party or banquet, etc.), side show, entertainment
私物|private property, personal belongings, personal effects
隠居|retirement (from work), leading a quiet life (after retirement)
名産|noted product, local specialty
産後|postpartum, after childbirth
転回|revolution, rotation
茶の湯|tea ceremony, chanoyu
観覧|viewing
熱量|quantity of heat (e.g. in calories, BTU, etc.), heat value, calorific value
両極|both extremities
眼球|eyeball
領地|territory, dominion, grounds (e.g. school)
修学|learning
和文|Japanese text, sentence in Japanese
特派|send specially, special envoy
切開|incision, operation, section
来場|attendance
据え付ける|to install, to equip, to mount
改悪|changing (something) for the worse, disimprovement, deterioration
庶務|general affairs
概説|overview, outline, rough summary
刷り|printing
利根|intelligence, cleverness, innate aptitude
進呈|presentation (e.g. of a gift)
興じる|to amuse oneself, to make merry
清純|purity, innocence
静的|static
宣教|religious mission, religious proclamation
見世物|show, exhibition, spectacle
対して|for, in regard to, per
ど忘れ|"lapse of memory, (something) slipping one's mind, forgetting for a moment something one knows well"
報ずる|to inform, to report
きまり悪い|embarrassed, ashamed
ボルト|volt
レース|race
ヤング|young
１０分|10 minutes
件|the aforementioned, the said, (man, incident, etc.) in question, the above-mentioned, the aforesaid
社|(Shinto) shrine
御覧なさい|(please) look
機|loom
明白|plain, frank, candid, open, direct, straightforward, unabashed, blatant, flagrant
一見|first visit to inn, restaurant, etc. without an introduction
きっかり|exactly, just, precisely
掠る|to graze (e.g. bullet), to scratch, to touch lightly
いざ|now, come (now), well
細やか|tender, warm, caring, thoughtful
懐く|to become attached (to), to take (to), to become affectionate (with), to be tamed, to get close (e.g. to someone emotionally), to become intimate (with)
間誤付く|to be confused, to be flustered, to be at a loss
それ故|therefore, for that reason, so, because of that
びり|last (on the list), (at the) bottom, (in) last position, tailender
気触れる|to develop a rash or inflammation (e.g. in response to a skin irritant), to react to (something)
てんで|(not) at all, completely, utterly, entirely, altogether
稲光|(flash of) lightning
詰る|to rebuke, to scold, to tell off, to find fault, to harp on, to reprove
ダブる|to be duplicated, to be repeated
遣り通す|to carry through, to achieve, to complete
すばしこい|nimble, smart, quick
館|(large) building, public building, hall
事によると|possibly, maybe, perhaps
揃い|set, suit, uniform collection, matching items
干し物|things dried in the sun (esp. clothes, dyed cloth, etc.)
すんなり|slim, slender, lithe, supple
ぐっと|suddenly, at once, in one go, with a jerk, with a gulp
ちやほや|to make a fuss over, to pamper, to spoil, to indulge, to flatter (with attention)
しぶとい|tenacious, tough, enduring, dogged, headstrong, stubborn, obstinate, unyielding
海鷂魚|ray (any fish of superorder Batoidea)
沈澱|precipitation, deposition, settlement (e.g. of sediment)
当て字|kanji used as a phonetic symbol, instead of for the meaning, phonetic-equivalent character, substitute character
道場|dojo, hall used for martial arts training
し尿|excreta, raw sewage, human waste, night soil
ベスト|best
ソース|sauce
パンク|puncture, flat tyre (tire), blowout
チェンジ|change, changing
未|the Sheep (eighth sign of the Chinese zodiac), the Ram, the Goat
イエス|Jesus (Christ)
ベース|base, basis, theme, basic ingredient
アクセル|accelerator (pedal), gas pedal
キャリア|career, occupation
シック|chic, stylish, smart
ジャンボ|jumbo, jumbo-sized
ジャンパー|(short) jacket, blouson, windbreaker, jumper
フィルター|filter (esp. camera)
マッサージ|massage
レンジ|range, stove, cooker
オートマチック|automatic
スプリング|(coil) spring
ペア|pair, set of two
ダンプ|dump
ティッシュペーパー|tissue paper, tissue, facial tissue
甕|earthenware pot
杯|sake cup, cup for alcoholic beverages
間々|occasionally, now and then, sometimes
宝器|treasured article or vessel, outstanding individual
仙|hermit, wizard
罰|(divine) punishment, curse, retribution
凝る|to congeal, to gelatinize, to jellify, to jell, to gell, to freeze
主なる|main, principal, important
歩|pawn
甲|first sign of the Chinese calendar
古|antiquity, ancient times
園|garden, orchard, park
豪儀|great, grand
倅|son
一敗|one defeat
経緯|details, particulars, sequence of events, circumstances, situation, how things got this way
構え|structure, construction, appearance
下地|groundwork, foundation
下番|going off duty
下吏|lower official
真ん円い|perfectly round, perfectly circular
吹奏|playing (a wind instrument), blowing
佳句|beautiful passage of literature
世辞|flattery, compliment
点線|dotted line, perforated line
殿|rear, rear unit guard
些事|something small, something petty, trifle
感無量|deep emotion, being filled with emotion
蕩ける|to melt (and become soft or liquid)
偏|left-hand radical of a character
参上|calling on, visiting
仕付ける|to be used to, to get accustomed to, to be in the habit of doing
干し|drying, dried
成る丈|as (much) as possible, as (much) as one can, wherever practicable, if possible
欲深い|greedy
すれ違い|passing each other
式場|ceremonial hall (e.g. wedding, funeral), hall for ceremonies, place of ceremony
溜まり|pile, pool, collection
講読|reading, translation
謝絶|refusal, declining
取り混ぜる|to mix, to put together
手回し|turning by hand, hand-turned, hand-cranked
局限|limit, localize, localise
尉|inspector (third highest of the four administrative ranks of the ritsuryō system)
亜科|subfamily
埋め込む|to bury, to embed, to implant
延いては|by extension, in turn, by the same token, in addition, as well, consequently
旧事|past events, bygones
出切る|to be out of, to have no more at hand
天地|heaven and earth, the universe, the world, nature
異見|different opinion, different view, dissenting view, objection
数詞|numeral
助|help, rescue, assistant
箇条書き|itemized form, itemised form, itemization, itemisation
梢|treetop, tip of a branch
蔵|warehouse, storehouse, cellar, magazine, granary, godown, depository, treasury, elevator
画期|transition from one epoch to another, change of era
仕舞い|end, close, finish, termination
萎びる|to shrivel (e.g. cut vegetables, skin), to wilt, to fade, to wither, to be wizened
丁々|(sound of) hitting repeatedly, pummelling, clashing, clacking, clicking (e.g. of go stones)
取り替え|swap, exchange
謙る|to deprecate oneself and praise the listener, to abase oneself
捕吏|constable, policeman
進度|progress
壕|moat, fosse, trench, ditch
一別|parting
洋灯|lamp
清濁|good and evil, purity and impurity
ＬＡＭＰ|LAMP, solution stack of free, open source software
契る|to pledge, to vow, to promise, to swear
外方|the other way
浅ましい|wretched, miserable, shameful, mean, despicable, abject
こげ茶|dark brown, olive brown
相|together, mutually, fellow
奉る|to offer, to present
ホール|hall (dance, concert, etc.)
バット|bat (in baseball, cricket, etc.)
シート|seat
嫋か|supple, flexible, elastic
エアメール|airmail, air mail
判|seal, stamp, monogram signature
ミセス|Mrs
竿|rod, pole
手数|trouble, bother
流|way, manner, style, fashion, mode
いっそ|rather, sooner, preferably, might as well, just
強いて|by force
ぶかぶか|too large (clothing), baggy, loose-fitting
ドリル|drill bit, drill
きちっと|exactly, perfectly
ランプ|lamp, light
カット|cut, cutting
ポーズ|pose
レディー|lady
デコレーション|decoration
トーン|tone
アワー|hour
インターナショナル|international
エレガント|elegant
フォーム|form
ネガ|negative
サンキュー|thank you, thanks
ルーズ|loose (e.g. belt)
クラブ|nightclub
セレモニー|ceremony
カムバック|comeback
タイムリー|timely, well-timed
国定|state-sponsored, national
ずれ|gap, lag, slippage
雑木|various kinds of small trees, assorted trees
立方|way of standing
哉|how!, what!, alas!
城下|land near a castle
霰|hail (esp. hailballs under 5 mm), graupel
業|karma
インターチェンジ|interchange, service interchange
鞠|ball (for sport, games, etc.)
サン|sun
奴|"servant (esp. a samurai's attendant)"
基|basis, foundation, origin, source
代|substitution
伝言|(verbal) message, word (from someone)
魂|Yang energy, spirit
金蔵|treasure house, treasury
溝|10^32, hundred nonillion
長|head, chief, leader
空き間|vacancy, room for rent or lease
斑|spots, speckles, mottles
違える|to change, to alter
反|variable measure of fabric (28.8 cm in width), for kimonos: at least 10 m in length, for haori: at least 7.27 m in length, for other clothes: at least 6.06 m in length
凝らす|to freeze, to congeal
艶|charming, fascinating, voluptuous
華奢|lavish, luxurious, showy, gaudy
重|-fold, -ply
擦れる|to rub, to chafe
弛み|slack, slackening, sagginess, flabbiness (skin, etc.)
棟|large building, building with a long roof
おっかない|frightening, scary
ずらっと|in a line, in a row
優|gentle, affectionate
拗れる|to get complicated, to grow worse, to turn sour
悪日|unlucky day
ひょっと|possibly, perhaps, perchance
秭|10^24, septillion
日当|daily allowance, daily wages
出来物|tumour, tumor, growth, boil, ulcer, abscess, rash, pimple
於て|at (a time or place), in, on
嘆|sigh
ぼやく|to grumble, to complain
嫌に|awfully, terribly
ふんだん|plentiful, abundant, ample, lavish
ぼつぼつ|gradually, little by little, in a breezy manner
げっそり|to be disheartened, to be dejected, to be discouraged, to be disappointed
資格|qualifications, requirements, capabilities
古代|ancient times, distant past, antiquity
理性|"reason, reasoning power, (one's) sense"
預金|deposit, bank account
比例|proportion
進化|evolution
捕虜|prisoner (of war), POW, captive
定年|(compulsory) retirement age, age limit
気質|disposition, temperament, nature, mentality, spirit, character, trait, turn of mind
連邦|federation (of states), confederation, commonwealth, union
介護|nursing, care, caregiving, caring
斜面|slope, slanting surface, bevel
神秘|mystery, mysteriousness, secret
下痢|diarrhea, diarrhoea
発作|fit, spasm, attack, seizure
結晶|crystal, crystallization, crystallisation
鉛|lead (Pb)
小売|retail
義理|duty, sense of duty, honor, honour, decency, courtesy, debt of gratitude, social obligation
地形|terrain, geographical features, topography
戸籍|family register
棄権|abstention (from voting), renunciation (of a right), withdrawal (from a contest)
炒める|to fry, to saute, to stir-fry
送金|remittance, sending money
居住|residence, abode, dwelling
風俗|manners, customs
品種|type (of goods), sort
地主|landowner, landlord, landlady
混血|mixed race, mixed parentage
調停|arbitration, conciliation, mediation
禅|dhyana (profound meditation)
産物|product, produce
法案|bill (law), measure
尚|still, yet
遅れ|delay, lag, postponement, falling behind
絶望|despair, hopelessness
最善|the very best, utmost
適応|adaptation, accommodation, conformity
他方|one (esp. of two), the other, one way, the other way, one direction, the other direction, one side, the other side, one party, the other party
図る|to plan, to attempt, to devise
収容|accommodation, taking in, receiving, housing, seating, admission (of patients, students, etc.)
愛想|amiability, friendliness, affability, sociability
徒歩|walking, going on foot
年生|nth-year student, nth-year pupil
快い|pleasant, agreeable, comfortable, refreshing
任務|duty, function, office, mission, task, role
征服|conquest, subjugation
漂う|to drift, to float
通|authority, expert, connoisseur, well-informed person
返済|repayment, reimbursement, refund, redemption
断言|assertion, declaration, affirmation
繁栄|prosperity, thriving, flourishing
形成|formation, molding, making (up), taking form, giving form to
創造|creation
逃亡|escape, flight, running away, elopement, fleeing
操縦|steering, piloting, flying, control, operation, handling
作|work (e.g. of art), piece, production
消息|news (from someone), letter, contact
捜索|search (esp. for someone or something missing), manhunt
境遇|"one's circumstances, environment, situation (in life)"
有望|promising, hopeful, full of promise
新人|newcomer, new figure, new member, recruit, rookie, new talent, new star
手本|model, (good) example, exemplar, paragon
取っ手|handle, grip, knob
帯びる|to wear (a sword, decoration, etc.), to carry, to bear
享受|enjoyment (of freedom, beauty, etc.), reception (of a right, privilege, rank, etc.), having
待ち望む|to wait eagerly for, to look forward to
描写|depiction, description, portrayal
携帯|"carrying (on one's person or in the hand)"
動揺|shaking, trembling, pitching, rolling, oscillation
脱出|escape, getting away (from), getting out (of)
個性|individuality, personality, quirk, idiosyncrasy, character, individual characteristic
爆破|destructive blast, blowing up, explosion
版|edition, version, printing, impression, implementation (of software)
疑惑|doubt, misgivings, distrust, suspicion
効き目|effect, virtue, efficacy, impression
手当|salary, pay, compensation, allowance (e.g. housing allowance), benefit, bonus
着手|starting work (on), setting to work (on), setting about (doing), beginning, commencing, embarking on
問い合わせる|to enquire, to inquire, to seek information
記述|description, account
対等|equality (esp. of status), equal footing, equal terms
弓|bow (weapon)
良識|good sense
浮気|extramarital sex, affair, fooling around
有りのまま|as it is, plain (truth), bare, undisguised, unvarnished, unexaggerated, honest, true, frank, candid
営む|to run (a business), to operate, to conduct, to practice (law, medicine, etc.)
労力|labour, labor, effort, toil, trouble
自覚|self-consciousness, self-awareness
阻止|obstruction, prevention, hindrance, check, blocking, stopping
統治|rule, reign, government, governing
専用|"(one's) exclusive use, private use, personal use"
補給|supply, supplying, replenishment
現地|actual place, actual location, the spot, the scene, the field, (on) site
引き上げる|to pull up, to drag up, to lift up
掛け|credit
権|right (to do something)
野外|outdoors, outside, open air
荒らす|to lay waste, to devastate, to damage
好ましい|nice, likeable, desirable
偽物|spurious article, forgery, counterfeit, imitation, sham
復活|revival (of an old system, custom, fashion, etc.), restoration, return, comeback
お手上げ|"being done for, giving up, being in a hopeless situation, not knowing what to do, being brought to one's knees, throwing up (one's) hands"
了解|comprehension, consent, understanding, agreement
富豪|wealthy person, millionaire
対話|dialogue, conversation, talk, discussion, communication
充実|fullness, completeness, perfection, substantiality
妨害|obstruction, hindrance, blocking, disturbance, interference, interruption, jamming (a signal)
陳列|exhibition, display, putting on show
故人|the deceased, the departed
仕上げ|finish, finishing, finishing touches
改良|improvement, reform
似通う|to resemble closely
統合|integration, unification, unity, combination, consolidation, synthesis
途上|on the way, en route
何気ない|casual, unconcerned, nonchalant, indifferent, offhand
仕掛ける|to start, to begin, to commence
騒動|strife, riot, rebellion, turmoil
称する|to take the name of, to call oneself
小柄|small build, small stature, petite
意欲|will, desire, eagerness, interest, drive, motivation, urge, ambition
初|first, new
未定|not yet fixed, undecided, pending, TBD
復興|revival, reconstruction, restoration, rebuilding, recovery, renaissance
名高い|famous, noted, renowned, celebrated, well-known
出動|mobilization, going into action, being dispatched, being sent out, being called in, turning out
残高|(bank) balance, remainder
無言|silence (not speaking), muteness
脱退|withdrawal (e.g. from an organization), secession, leaving, pulling out
所持|"possession, having (on one's person), carrying (with one)"
緩和|relief, mitigation, alleviation, relaxation (of restrictions, tensions, etc.), easing, softening
勧め|recommendation, advice, suggestion, encouragement
勧誘|invitation, solicitation, canvassing, canvasing, inducement, persuasion, encouragement
連帯|solidarity
近郊|outskirts, environs (of a city), surrounding area, surroundings
窮屈|narrow, tight, cramped
封|seal
膨れる|to swell (out), to expand, to be inflated, to distend, to bulge
有り様|state, condition, circumstances, sight, spectacle
再現|reappearance, reemergence, return, revival
軸|axis, shaft, axle
対談|talk, dialogue, conversation
創刊|foundation (of a newspaper, magazine, etc.), starting, launching, first publication
未練|lingering attachment, lingering affection, regret, reluctance, ruefulness
碑|stone monument bearing an inscription (esp. memorial for future generations), stele, stela
発掘|excavation, exhumation, digging up, unearthing
了承|acknowledgement, acknowledgment, understanding, approval, consent
公団|public corporation
運搬|transport, transportation, conveyance, carriage
人情|humanity, empathy, kindness, sympathy
診療|diagnosis and treatment, medical care
子息|"(another's) son"
許容|permission, allowance, acceptance, tolerance, pardon
軽快|light (of movements), nimble, sprightly, springy
火花|spark
総合|synthesis, combination, integration, putting together
戦力|war potential, military strength, fighting power
待望|waiting expectantly, waiting eagerly, looking forward to
引き起こす|to cause, to induce, to bring about, to provoke
乗り込む|to board, to embark on, to get into (a car), to man (a ship), to help (someone) into
貫く|to go through, to pierce, to penetrate
久しい|long (time that has passed), old (story)
設ける|to prepare, to provide
同封|enclosing (e.g. with a letter)
待ち遠しい|longed-for, anxiously awaited
見合わせる|to exchange glances, to look at each other
霞む|to become misty, to become hazy
群がる|to swarm, to gather
几帳面|methodical, precise, meticulous, scrupulous, regular, punctual
慣らす|"to accustom, to train (e.g. one's ear)"
唾|saliva, spit, spittle
戸締まり|locking up (doors and windows), fastening the doors
皺|wrinkle, crease
鬱陶しい|gloomy (e.g. mood), depressing
剥げる|to peel off, to come off, to flake off, to be worn off
閉口|"to be stumped, to be at a loss, to be at one's wits' end, to be nonplussed"
つかの間|moment, brief space of time
卑しい|lowborn, humble, lowly
臨む|to look out on, to overlook, to front onto
全滅|total destruction, complete destruction, annihilation, being wiped out
体つき|body build, figure
洒落る|to dress stylishly
気まぐれ|whim, caprice, fancy
籠もる|"to shut oneself in (e.g. one's room), to be confined in, to seclude oneself, to hide away, to stay inside (one's shell)"
瞑る|"to close (one's eyes), to shut"
お負け|something thrown in (with a purchase), something extra, free gift, freebie, giveaway, premium, prize
剥ぐ|to tear off, to peel off, to rip off, to strip off, to skin, to flay, to bark
中和|neutralization, neutralisation
渋い|astringent, bitter, puckery, rough, harsh, tart
煙る|to smoke (e.g. fire), to billow smoke, to smoulder, to smolder
先だって|the other day, some time ago, recently
徐行|going slowly (esp. to enable a vehicle to stop immediately), going at a reduced speed, slowing down, reducing speed
画|stroke (of a kanji)
原点|starting point, origin, beginning
立法|legislation, lawmaking
あべこべ|contrary, opposite, inverse, reverse, back-to-front
返還|return, restoration
揺らぐ|to swing, to sway, to shake, to tremble
運送|transport, freight, shipping, moving (goods)
慣れ|practice, experience, habituation
準じる|to follow (a rule, precedent, etc.), to conform to (the law, standards, etc.), to be based on, to apply correspondingly
穂|ear (of a cereal plant), head, spike
出直し|starting from scratch, making a fresh start, redoing
重複|duplication, repetition, overlapping, redundancy, restoration
情け深い|tender-hearted, compassionate, charitable, good-hearted
駆けっこ|(foot) race, sprint