儀式|ceremony, rite, ritual, service
職人|craftsman, artisan, tradesman, worker, workman
南極|South Pole
北極|North Pole
新幹線|Shinkansen, bullet train
昼寝|(afternoon) nap, sleeping during the day, siesta
大通り|main street, avenue, boulevard
木材|lumber, timber, wood
運河|(navigable) canal, waterway
遊園地|amusement park
天皇|Emperor of Japan
蛇口|faucet, tap
溶岩|lava
武士|samurai, warrior
名字|surname, family name, last name
面接|interview (e.g. for a job)
資料|material, materials, data, information, documents
解放|release, unleashing, liberation, emancipation, setting free
群れ|group, crowd, flock, herd, bevy, school, swarm, cluster (e.g. of stars), clump, pack (e.g. of dogs)
望遠鏡|telescope
唇|lip, lips
温泉|hot spring
書店|bookshop, bookstore
液体|liquid
通勤|commuting to work
広場|public square, square, plaza, piazza, forum
演劇|drama, theatre, theater, play
井戸|water well
煙突|chimney, smokestack, funnel (of a ship), stovepipe
過失|accident (caused by negligence), error, blunder
垣根|hedge, fence
果実|fruit, nut, berry
皮膚|skin
電池|battery, cell
矛盾|contradiction, inconsistency
通訳|interpretation (i.e. oral translation)
乾杯|cheers, bottoms-up, prosit
通貨|currency
花火|fireworks
車庫|garage, carport, depot (for trains, buses, etc.), carbarn
中世|Middle Ages (in Japan esp. the Kamakura and Muromachi periods), medieval times, mediaeval times
火山|volcano
虹|rainbow
相撲|sumo (wrestling)
観念|idea, notion, concept, conception
回転|rotation, revolution, turn, spin
競馬|horse racing
枕|pillow, bolster
吹雪|snow storm, blizzard
水素|hydrogen (H)
基礎|foundation, basis
停電|power outage, electricity outage, blackout, failure of electricity supply
毛皮|fur, skin, pelt
鐘|bell (often a large hanging bell), chime
公害|pollution, public nuisance, contamination
灰色|grey, gray, ashen
政党|political party
足跡|footprints
公共|public (facilities, service, etc.), communal
公式|official, formal
牧場|farm (livestock), stock farm, ranch, station
百科事典|encyclopedia, encyclopaedia
名所|famous place, noted place, place of (scenic or historical) interest, sights (to see)
強化|strengthening, intensifying, reinforcement, enhancement, solidification
血液|blood
車輪|(vehicle) wheel
死体|dead body, corpse, cadaver, carcass
蒸気|steam, vapour, vapor
姿勢|posture, pose, position, stance, carriage (of the body)
文体|literary style
薬局|"pharmacy, drugstore, chemist's (shop)"
消化|digestion (of food)
磁石|magnet
神話|myth, legend
看板|signboard, sign, billboard, hoarding, doorplate
大工|carpenter
森林|forest, woods
乗り換え|transfer (trains, buses, etc.), change, connection
電力|electric power
家屋|house, building
東洋|the East, the Orient, (East) Asia
顕微鏡|microscope
方言|dialect, provincialism
酢|vinegar
滝|waterfall
面積|area (measurement), square measure, size (of land), floor space
寮|hostel, dormitory
撮影|photography (still or motion), photographing, filming, shooting, (video) recording
給与|pay, salary, wages
血圧|blood pressure
将棋|shogi, Japanese chess
継続|continuation, continuance, going on
直線|straight line
伝記|biography, life story
刺身|sashimi (raw sliced fish, shellfish or crustaceans)
国籍|nationality, citizenship
無限|infinity, infinitude, eternity
反省|reflection, reconsideration, introspection, meditation, contemplation
診断|diagnosis, medical examination
明け方|dawn, daybreak
銅|copper (Cu)
包装|packing, wrapping
手首|wrist
彫刻|carving, engraving, sculpture
倉庫|storehouse, warehouse, godown
香水|perfume, scent
姓|surname, family name
噴火|eruption, volcanic eruption
統一|unity, consolidation, uniformity, unification, compatible
商社|trading company
先祖|ancestor, forefather, foremother
手前|before oneself, in front of one, nearby
記号|symbol, code, sign, notation
分布|distribution
行列|line, queue, procession, parade
深夜|late at night
太鼓|drum
煮る|to boil, to simmer, to stew, to seethe
和服|Japanese clothes
引き分け|draw (in competition), tie game
包丁|kitchen knife, carving knife
竹|bamboo (any grass of subfamily Bambusoideae)
表紙|cover (of a book, magazine, etc.), binding
電柱|utility pole, power pole, telephone pole, telegraph pole
学年|academic year, school year
園芸|horticulture, gardening
温室|greenhouse, hothouse, conservatory, glasshouse
原理|principle, theory, fundamental truth
算数|arithmetic
農産物|agricultural produce
平日|weekday, ordinary days (i.e. non-holiday)
古典|classic (work, esp. book), the classics
通路|passage, pathway, roadway, avenue, aisle
編集|editing, compilation
集合|meeting up, gathering, assembly
光線|beam, light ray
電球|light bulb
測定|measurement
宴会|party, banquet, reception, feast, dinner
中年|"middle-age, middle age, midlife, one's middle years"
体操|gymnastics, physical exercises
親指|thumb
淡水|fresh water (i.e. not salt water)
湿度|level of humidity
垂直|vertical
税関|customs, customs house
餅|mochi, (sticky) rice cake
水平|horizontal, level, even
自然科学|natural science
確率|probability, likelihood, chances
性別|gender, distinction of sex, sex
大学院|graduate school
売買|trade, buying and selling, trafficking (e.g. of humans, arms, drugs), dealing
電波|radio wave, reception, signal
水蒸気|water vapour, water vapor, steam
交流|exchange (e.g. cultural), interchange, interaction, mingling, mixing, coming together
俳句|haiku, 17-mora poem, usu. in 3 lines of 5, 7 and 5 morae
歯磨き|"dental brushing, brushing one's teeth"
随筆|essays, miscellaneous writings, literary jottings
漁業|fishing industry, fishery
線路|railway track, railway line, railroad, railway, track, line
幼稚園|kindergarten, nursery school, preschool
透明|transparent, clear
灯台|lighthouse
洗剤|detergent, cleanser, cleaning agent, washing material
観測|observation, survey, measurement
役所|government office, public office
冠|traditional cap worn by Shinto clergy and courtiers
祝日|national holiday, public holiday
名刺|business card
童話|"children's story, fairy tale"
会館|meeting hall, assembly hall
紫|purple, violet
工夫|devising (a way), contriving, inventing, thinking up, figuring out, coming up with, working out
車掌|(train) conductor
歯車|gear, cogwheel
半島|peninsula
名物|famous product, special product, speciality, specialty
流域|drainage basin, catchment basin, river basin, watershed, valley
司会|leading a meeting, presiding over a meeting, officiating at a ceremony, chairmanship
接続|connection, attachment, union, join, joint, link
転々|moving from place to place, being passed around repeatedly
学部|department of a university
農薬|agricultural chemical (i.e. pesticide, herbicide, fungicide, etc.), agrochemical, agrichemical
社説|editorial, leading article, leader
気圧|atmospheric pressure
重力|gravity, gravitation, gravitational pull
真空|vacuum, hollow, empty
発電|generation of electricity, power generation
頂点|vertex, apex
圧縮|compression
郡|district, county
西暦|Common Era, CE, Christian Era, anno domini, AD
工芸|industrial arts, craft
索引|index (in a book)
輸血|blood transfusion
峠|(mountain) pass, highest point on a mountain road, ridge
自治|self-government, autonomy
筆記|(taking) notes, copying
紙幣|paper money, note, bill
杉|Japanese cedar (Cryptomeria japonica)
測量|measurement, surveying
機関車|locomotive, engine
為替|money order, draft
学会|learned society, scientific society, academy, academic meeting, academic conference
社会科学|social science
献立|menu, bill of fare
合同|combination, union, joining, incorporation, amalgamation, merger, fusion
踏切|railway crossing, railroad crossing, train crossing, level crossing
曖昧|vague, ambiguous, unclear
梯子|ladder
肘|elbow
絨毯|carpet, rug, runner
編み物|knitting, knitted material, crochet
釘|nail, spike, tack, rivet, brad, (pachinko) pin
包帯|bandage, dressing
気体|gas, vapour, vapor, gaseous body
茹でる|to boil (something in hot water)
飢饉|famine, crop failure
胡椒|pepper
煉瓦|brick
直角|right angle, perpendicular
錆|rust
迷信|superstition, superstitious belief
待合室|waiting room
失恋|disappointed love, broken heart, unrequited love, being lovelorn
櫛|comb
省略|omission, leaving out
蒸発|evaporation
回り道|detour, circuitous route, diversion
名詞|noun
扇風機|electric fan
裁縫|sewing, needlework
正方形|square
形容詞|adjective, i-adjective (in Japanese)
蕎麦|buckwheat (Fagopyrum esculentum)
人差し指|index finger, forefinger
副詞|adverb
消防署|fire station
定規|(measuring) ruler
蛍光灯|fluorescent lamp, fluorescent light
座布団|zabuton, flat floor cushion used when sitting or kneeling; usu. rectangular
人文科学|humanities, social sciences, liberal arts
括弧|brackets, parentheses
海水浴|swimming in the ocean, sea bathing, seawater bath, going for a dip in the ocean
矢印|arrow (symbol)
時間割|timetable (esp. a weekly school timetable), schedule
体積|capacity, volume
箒|broom
敬語|honorific, term of respect, polite expression, honorific language
経度|longitude
長方形|rectangle, oblong
温帯|temperate zone
水筒|canteen, flask, water bottle, thermos
風呂敷|wrapping cloth, cloth wrapper
薬指|ring finger, third finger, fourth finger (in piano-playing)
下駄|geta, traditional Japanese wooden sandal
障子|shoji (paper sliding door)
複写|copying, duplication, reproduction, copy
手洗い|"washing one's hands, water (or basin, etc.) for washing one's hands"
噴水|water fountain
便所|toilet, lavatory, water closet, restroom, bathroom
肌着|underwear, underclothes, lingerie, chemise, singlet
中指|middle finger, long finger, second finger, tall finger
方程式|equation, formula
螺子|screw
主語|subject
零点|zero (points, marks), no marks
長所|strong point, merit, virtue, advantage
休息|rest, relief, relaxation
湿気|moisture, humidity, dampness
勝負|victory or defeat
役人|government official
相互|mutual, reciprocal
引っ越し|moving (dwelling, office, etc.), changing residence
海洋|ocean, sea
関西|Kansai, region consisting of Osaka, Kobe, Kyoto and surrounding prefectures
上り|ascent, climbing, ascending (path), climb
正門|main gate, main entrance
南米|South America
連合|union, combination, alliance, confederation, coalition
下町|low-lying part of a city (usu. containing shops, factories, etc.)
大小|size
一応|more or less, though not quite satisfactorily, after a fashion, pretty much, roughly, so far as it goes, technically
御免|"I'm sorry, my apologies, excuse me, pardon me"
一旦|once
麓|foot (of a mountain or hill), bottom, base
生け花|ikebana, Japanese art of flower arrangement
欧米|Europe and America, the West
稽古|practice, practising, training, study
隙間|crevice, crack, gap, opening, clearance
箪笥|chest of drawers, bureau, cabinet, tansu, dresser
瀬戸物|earthenware, porcelain, china, pottery, crockery
合流|confluence (of rivers), flowing together, joining
下る|to descend, to go down, to come down
間もなく|soon, shortly, before long, in a short time, in a little while
耐える|to bear, to stand, to endure, to put up with
少なくとも|at least
押さえる|to pin down, to hold down, to press down, to hold in place, to hold steady
知り合い|acquaintance
相変わらず|as usual, as always, as before, as ever, still
率直|frank, candid, straightforward, openhearted, direct, outspoken
努める|to endeavor (to do), to endeavour, to try hard, to work hard, to strive, to make an effort, to exert oneself, to devote oneself, to be committed (to doing)
殴る|to strike, to hit, to beat, to punch
慌てる|to become confused (disconcerted, disorganized, disorganised), to be flustered, to panic
診る|to examine (medically)
何とも|really, very, extremely, terribly, awfully
稀|rare, seldom
迫る|to approach, to draw near, to be imminent
狙う|to aim at (with a weapon, etc.)
浮かべる|to float, to set afloat, to launch
交代|alternation, change, relief, relay, shift, substitution (sports, etc.), taking turns
枯れる|to wither (of a plant), to be blasted, to die
当たり前|natural, reasonable, obvious
外れる|to be disconnected, to get out of place, to be off, to be out (e.g. of gear)
広げる|to spread, to extend, to expand, to enlarge, to widen, to broaden
取り消す|to cancel, to withdraw, to retract, to take back (words, etc.), to revoke
伝わる|to spread (of a rumour, news, etc.), to travel, to circulate, to go around, to be passed around, to become known
見送る|to see someone off (at a station, an airport, etc.), to escort (e.g. home)
接する|to touch, to come in contact with, to border on, to adjoin, to be adjacent, to be close
分かれる|to branch, to fork, to diverge
売り上げ|amount sold, sales, proceeds, takings, turnover
刺す|to pierce, to stab, to prick, to stick, to thrust
配る|to distribute, to hand out, to deliver, to deal out, to serve out
属する|to belong to, to come under, to be affiliated with, to be subject to
作成|making (a report, plan, contract, etc.), drawing up, writing out, preparing, creating (a file, website, account, etc.)
呼び出す|to call (someone) to (the door, phone, etc.), to tell (someone) to come, to call up (on the phone), to summon, to page, to invoke (e.g. a spirit)
積む|to pile up, to stack
飢える|to starve, to be famished, to be hungry
懐かしい|dear (old), fondly-remembered, beloved, missed, nostalgic
性質|nature (of a person), disposition, temperament, character
話し合い|discussion, talk, tête-à-tête, conference
埋める|to bury (e.g. in the ground)
方針|policy, course, plan (of action), principle
建つ|to be erected, to be built
解散|breaking up (a meeting, gathering, etc.), dispersal (e.g. of a crowd)
兼ねる|to be unable to, to find difficult (unpleasant, awkward, painful) to do
余計|extra, more, too much, too many, excessive, superfluous, spare, surplus
法則|law, rule
発揮|show (of power, ability, etc.), exhibition, demonstration, display, manifestation
生き生き|in a lively way, vividly, freshly, animatedly, actively, energetically
夫妻|husband and wife, married couple
原稿|manuscript, copy, draft, notes, contribution
手続き|procedure, process, proceedings, formalities
実力|(real) ability, true strength, merit, efficiency, competency
別荘|holiday house, vacation home, villa
日差し|sunlight, rays of the Sun
通知|notice, notification, report, posting
本来|originally, primarily
女房|"wife (esp. one's own wife)"
国王|king, queen, monarch, sovereign
登場|entrance (on the stage), appearance (in a book, film, etc.)
動作|movement (of the body), action, motion, gesture
出張|business trip, official trip
蚊|mosquito
幼児|young child, toddler
皮肉|irony, sarcasm, cynicism, satire
以降|on and after, from ... onward, since
例外|exception
縛る|to tie, to bind, to fasten
傑作|"masterpiece, masterwork, chef d'oeuvre, fine piece of work"
一流|first-class, first-rate, top-flight, top-ranking, leading, eminent, top
集会|meeting, assembly, gathering, congregation, convention, rally
絞る|to wring (towel, rag), to squeeze
侵入|invasion, incursion, raid, aggression, intrusion, trespass, penetration, hacking
低下|fall, decline, lowering, deterioration, degradation
身分|(social) standing, status, position, rank
普及|diffusion, spread, popularization, promulgation, familiarization
全身|whole (body), full-length (e.g. portrait)
要領|point, gist, essentials, tenets, outline
周辺|circumference, outskirts, environs, around, in the area of, in the vicinity of
増大|enlargement, increase
校舎|school building, schoolhouse
不運|misfortune, bad luck, ill luck, ill fortune
分類|classification, categorization, sorting
公正|justice, fairness, impartiality
高度|altitude, height, elevation
改正|revision, amendment, alteration
満点|perfect score, full marks
郵送|mailing, posting
食器|tableware
一定|to fix, to settle, to standardize, to regularize
地点|spot, point, place, position
手入れ|care, looking after, repair, maintenance, tending, trimming, grooming
特定|specific, particular, designated, special
展開|development, evolution, progression, unfolding, (plot) twist
統計|statistics
項目|item, heading, category, clause
利害|advantages and disadvantages, interests (of parties)
調整|adjustment, regulation, coordination, reconciliation, tuning, fixing, tailoring
高める|to raise, to lift, to boost, to enhance
刻む|to mince, to cut fine, to chop up, to hash, to shred
構造|structure, construction, makeup, framework, organization, pattern
苦情|complaint, troubles, objection, grievance
学科|study subject, course of study
時速|speed (per hour)
手ごろ|handy, convenient
判事|judge, judiciary
日の出|sunrise
小遣い|pocket money, spending money, pin money, allowance
乱暴|violence, assault, rowdiness, wildness, running riot
標識|sign, mark, marker, beacon
見舞う|"to visit and comfort or console, to go to see (e.g. someone in hospital), to ask after (e.g. someone's health), to inquire after"
接近|getting closer, drawing nearer, approaching
役目|duty, role, function
頭脳|head, brains
往復|making a round trip, going and returning, coming and going
教養|"(understanding or appreciation of) culture, (one's) education, cultivation, sophistication, refinement"
素直|obedient, meek, docile, unaffected
知人|friend, acquaintance
重役|(company) director, executive, top management
反映|reflection (of light)
前後|front and rear, front and back, before and behind, back and forth
対策|measure, step, countermeasure, counterplan, countermove, strategy, preparation (e.g. for a test)
崩れる|to collapse, to crumble
弱点|weak point, weakness, shortcoming, defect, flaw, sore spot, tender spot
総理大臣|prime minister (as the head of a cabinet government), premier
無数|innumerable, countless, numberless
段階|stage, step, phase
役者|actor, actress
満員|full house, no vacancy, sold out, standing room only, full (of people), crowded
娯楽|amusement, entertainment, recreation, pleasure, pastime, hobby
解答|answer, solution
派手|showy, loud, flashy, gaudy
冷やす|to cool (from room temperature), to chill, to refrigerate
祖先|ancestor
基準|standard, basis, criterion, norm, reference, datum
早口|fast-talking, rapid talking
相違|difference, discrepancy, variation
中身|contents, interior, filling
分解|disassembly, dismantling, disaggregating, taking apart, breaking up, analysis, parsing
空中|sky, air, mid-air
油断|negligence, carelessness, inattention, unpreparedness
争う|to compete, to contest, to contend
塊|lump, mass, bundle, clump, clod, cluster
花嫁|bride
調節|regulation, adjustment, control
焦点|focus, focal point
停止|stoppage, coming to a stop, halt, standstill
箇所|place, point, part, spot, area, passage, portion
先頭|head (of a line, group, etc.), front, lead, forefront, vanguard
温まる|to warm oneself, to sun oneself, to warm up, to get warm
受話器|(telephone) receiver
寄せる|to come near, to let someone approach
期限|term, period, time frame
停車|stopping (of a train, car, etc.), stop
活躍|activity (esp. energetic or successful), great efforts, active participation
応対|dealing with (people, customers, complaints, etc.), receiving (callers, visitors, etc.), attending to, handling, serving
賞金|prize money, monetary award, reward
葬式|funeral
追加|addition, supplement, appending, appendix
口実|excuse, pretext
過程|process, course, mechanism
心得る|to know, to understand, to be aware of, to regard as, to take for
見学|inspection, study by observation, field trip, tour, review
回答|reply, answer
部品|parts, accessories, components
受験|taking an examination (esp. for entrance to a school or university)
果たして|as was expected, just as one thought, sure enough
標準|standard, level, norm
防止|prevention, check
推定|presumption, assumption
言葉遣い|speech, expression, wording, language
重ねる|to pile up, to heap up, to stack up, to put on top of another
発射|firing (esp. a rocket or missile), launching, shooting, discharge, catapult
恩恵|grace, favor, favour, blessing, benefit
不通|suspension, interruption, stoppage, tie-up, cessation
発売|sale, offering for sale, release (for sale), launch (product)
行事|event, function
恨み|resentment, grudge, malice, bitterness
改める|to change, to alter, to revise, to replace
見直す|to look at again
拡張|expansion, extension, enlargement
点数|marks, points, score, grade, runs (baseball)
形式|form (as opposed to substance)
気配|indication, sign, hint, sensation, feeling
指定|designation, specification, assignment, appointment, pointing at
神様|God, god
間隔|space, interval
活力|vitality, energy, dynamism
出迎える|to meet, to greet
純粋|pure, true, genuine, unmixed
短期|short-term
予備|reserve, spare
上下|top and bottom, high and low, above and below, upper and lower ends, up and down
申請|application, request, petition
窓口|counter, window, teller window, ticket window
未満|less than, under, below
録音|(audio) recording
作者|creator (of a work), author, writer, artist, composer, playwright, dramatist
謙虚|modest, humble
長男|eldest son (may be the only son), first-born son
過半数|majority
日時|date and time (of a meeting, departure, etc.)
公表|official announcement, proclamation
次ぐ|to follow, to come after, to come next (to), to rank next (to), to rank second (to)
採点|marking, grading, scoring
残らず|all, entirely, completely, without exception
物語る|to tell (a story), to give an account of (an event, experience, etc.), to relate, to recount
実物|real thing, original, actual
対立|confrontation, opposition, antagonism
受取り|receiving, receipt
縮小|reduction, curtailment, cut, cutback, scaling down, contraction, shrinkage
筆者|writer, author
一々|one-by-one, separately
休養|rest, relaxation, recreation, recuperation, convalescence
商店|shop, store, firm
親類|relative, relation, kin
性能|ability, performance, efficiency
過剰|excess, surplus, superabundance, overabundance
応用|(practical) application, putting to practical use
削る|to shave (wood, leather, etc.), to sharpen (e.g. pencil), to plane, to whittle, to pare, to scrape off, to erode
来日|arrival in Japan, coming to Japan, visit to Japan
混合|mixing, mixture, meld
就任|assumption (of office), taking up (a post), inauguration, installation
体制|order, system, structure, set-up, organization, organisation
理科|science (inc. mathematics, medicine, etc.), natural science
寿命|lifespan, life, lifetime
兵隊|soldier, sailor
綱|rope, cord, line
公衆|the public, general public
夕日|evening sun, setting sun
膨大|huge, vast, enormous, colossal, extensive, large
日陰|shade, shadow
隔てる|to separate (by distance, time, etc.), to isolate, to partition, to divide
原料|raw materials, ingredient
缶詰|canned food, tinned food
一段|even more, still more, much more, further
鑑賞|appreciation (of art, music, poetry, etc.)
整備|maintenance, servicing
破片|fragment, broken piece, splinter, chip, shard
両側|both sides
削除|deletion, elimination, erasure, striking out
開会|opening of a meeting
真っ先|the head, the foremost, beginning, the very front
看病|nursing (a patient)
近々|soon, before long, shortly, in the near future
臨時|temporary, provisional, interim
民間|private, non-governmental, non-official, civilian, civil
有料|fee-charging, paid, not free
交通機関|(means of) transportation, transport, transportation facilities, transportation system, transit system
書籍|book, publication
用語|term, terminology
地帯|zone, area, belt, region
雑音|noise (usu. unpleasant)
工事|construction work
盗難|theft, robbery
膨らます|to swell, to expand, to inflate, to bulge
日程|schedule, program, programme, agenda
問い合わせ|inquiry, query, enquiry
碁|go (board game)
材木|wood (for building), lumber, timber
小学生|elementary school student, primary school student, grade school student
創作|creation, production, creative work (novel, film, etc.), original work, (creative) writing
循環|circulation, rotation, cycle, loop
当日|day in question, appointed day, that very day, the day (of issue, publication, etc.)
実例|example, illustration, precedent
成立|formation, establishment, materialization, coming into existence
重量|weight
在学|attending (school, college, etc.), being enrolled, being a student
直前|just before, just prior to
先端|pointed end, tip, point, cusp (of a leaf, crescent moon, etc.), apex (of a curve)
規律|order, observance, discipline
強引|overbearing, coercive, pushy, forcible, high-handed
素人|amateur, layman, ordinary person, novice
栓|stopper, cork, plug, bung
起床|"rising (from one's bed), getting up, getting out of bed"
夜間|night, nighttime
限度|limit, bounds
対照|contrast, antithesis, comparison
薄暗い|dim, gloomy
貸家|house for rent
加速|acceleration, speeding up
家主|landlord, landlady
高級|high-class, high-grade, high-quality, high-end, luxury
中間|middle, midway, halfway, centre, center
特殊|special, particular, peculiar, unique
日用品|daily necessities
容器|container, receptacle, vessel, packaging
回数|number of times, frequency, count
快晴|clear weather, cloudless weather, good weather
逆さ|inverted, upside down, reversed, back to front
休業|suspension of business, temporary closure (of a store, school, etc.), shutdown, holiday
方面|direction, district, area
響き|echo, reverberation
刺さる|to stick into (of something with a sharp point), to prick, to pierce, to get stuck (in), to lodge (in)
外部|outside (e.g. of a building), exterior
文脈|context (of a passage), line of thought
子孫|descendant, posterity, offspring
区域|area, zone, district, quarter, section, limits, boundary
学級|(school) class
児童|children, juvenile
特色|characteristic, feature, idiosyncrasy, personal colour
改造|remodeling, remodelling, reconstruction, conversion, alteration, renovation, modification, reshuffling (e.g. a cabinet), reorganization, restructuring
植木|garden shrubs, trees, potted plant
意義|meaning, significance
深まる|to deepen, to heighten, to intensify
開放|opening (a door, window, etc.), leaving open
寸法|measurement, size, extent, dimension
岬|cape (on coast)
屋外|outdoors, outside
貝|shellfish
力強い|powerful, strong, forceful, vigorous
片道|one-way (trip)
長女|eldest daughter, first-born daughter
校庭|schoolyard, school playground, school grounds, campus
定期券|commuter pass, season ticket
厳重|strict, severe, stringent, rigorous, rigid, firm, strong, secure
能率|efficiency
鉢|bowl, pot, basin
基地|base (military, expedition, etc.)
再三|again and again, repeatedly
感想|impressions, thoughts, feelings, reactions
閉会|closure (of a ceremony, event, meeting, etc.)
全集|complete works, complete collection, complete series
欄|section (e.g. in a newspaper), column, page
持参|bringing, taking, carrying
課税|taxation
瞳|pupil (of the eye)
何しろ|in any case, at any rate, anyhow, anyway, as you know, for you see, particularly
実感|real feeling, actual feeling
絵の具|paint, coloring materials, colors, colours
実用|practical use, utility
架空|fictitious, imaginary, fanciful, fabricated
以後|after this, from now on, hereafter
順序|order, sequence
鉄砲|gun
育児|childcare, child-rearing, nursing, upbringing
写る|to be photographed, to be projected
水曜|Wednesday
案外|unexpectedly, surprisingly
成分|ingredient, component, composition
正面|front, frontage, facade, main
入社|joining a company, getting a job with a company, starting work at a company
汁|juice, sap
貸し出し|lending, loaning
後輩|junior (at work, school, etc.), younger people, younger student
地名|place name, toponym
下車|alighting (from a train, bus, etc.), getting off, getting out (of a car)
芯|wick, marrow, staple (for stapler), (pencil) lead, stuffing, pith
題名|title, caption, heading
効力|effect, efficacy, validity, potency
日帰り|day trip
標本|example, specimen, sample
評論|criticism, critique
各自|each (person), everyone, individual, respective
物置|storage room, storeroom, lumber room
氏名|(full) name, identity
美容|beauty, good figure, (beautiful) appearance, (beautiful) features
地味|plain, simple, subdued, sober
酸性|acidity
私立|private (establishment)
脂|fat, tallow, lard, grease
実績|achievements, actual results, accomplishments, past results, track record
粒|grain, bead, drop
鈴|bell (often globular)
免税|tax exemption, duty exemption
定員|fixed number (of people), prescribed number (of regular personnel, students, etc.), quota, numerical limit, complement
終点|terminus, last stop (e.g. train)
売店|stand, stall, booth, kiosk, store
超過|excess, surplus, exceeding (a limit, estimate, etc.), going over
不規則|irregular, unsystematic, unsteady, disorderly
外科|surgery (branch of medicine)
的確|accurate, precise, exact, appropriate, apt, right
募集|recruitment, invitation, selection, advertisement, taking applications
驚かす|to surprise, to frighten, to create a stir
人命|(human) life
研修|training (esp. in-service), induction course
区分|division, section, demarcation, partition, segmentation, compartment, (traffic) lane
飾り|decoration, ornament, trimmings
執筆|writing, authoring
体系|system, organization, organisation, architecture
下水|drainage, ditch, gutter, sewerage
地質|geological features
中途|halfway, midway, partway, mid-course
乗車|boarding (a train, bus, etc.), getting into (e.g. a taxi)
境界|boundary, border, limit, bounds, frontier
清掃|cleaning, clean-up, garbage collection, scavenging
定価|list price, regular price, established price
公務|official business, public business
課程|course, curriculum
東西|east and west
内線|phone extension, indoor wiring, inner line
解説|explanation, commentary, exposition, elucidation
続々|successively, one after another
催し|event, festivities, function, social gathering, auspices, opening, holding (a meeting)
街角|street corner
文献|literature, books (reference), document
開通|opening (of a new road, railway, etc.), going into operation (e.g. telephone communication), beginning services
出入り口|exit and entrance
実習|practice (in the field), training (esp. practical and hands-on), practical exercise, drill
暴れる|to act violently, to rage, to struggle, to be riotous
殻|shell, husk, hull, pod, chaff
苦心|pains, hard work, effort, trouble, labour, labor
本部|headquarters, head office, main office
盆地|basin (e.g. between mountains)
薬品|medicine, chemicals
容積|capacity, volume
強気|confident, assured, self-assured, firm, strong, cocksure
乾電池|dry cell, battery
肯定|affirmation
感激|deep emotion, impression, inspiration
巡査|police officer, policeman, constable
寝台|bed, couch
中旬|middle ten days of a month, 11th to 20th day of a month
断定|conclusion, decision, judgement, declaration
別々|separate, respective, different
留守番|care-taking, house-sitting, house-watching, staying at home
酒場|bar, pub, tavern
生年月日|birth date, date of birth, DOB
勝敗|victory or defeat, outcome (of a game, battle, etc.)
送料|postage, carriage, shipping charge
書道|calligraphy (esp. Asian calligraphy based on Chinese characters)
消耗|exhaustion, consumption, using up, dissipation, waste
攻める|to attack, to assault, to assail
灯油|kerosene, paraffin, lamp oil
締め切る|to close up, to shut up (e.g. behind doors)
分量|amount, quantity
内科|internal medicine
南北|north and south, north to south
高等|high class, high grade
日課|daily routine, daily work, daily lesson
年度|fiscal year (usu. April 1 to March 31 in Japan), financial year
安易|easy, simple
紺|navy blue, deep blue
格別|particular, special, exceptional, especial
付属|being attached (to), being affiliated (to), belonging (to), going with
名作|masterpiece
学術|science, learning, scholarship, arts and sciences, academic pursuits
学力|scholarly ability, scholarship, knowledge, literary ability
有無|existence or nonexistence, presence or absence
用途|use, service, purpose
製作|manufacture, production
助教授|assistant professor, associate professor
盆|tray
客席|guest seating (e.g. theater, stadium), passenger seat (e.g. taxi)
賞品|prize, trophy
食塩|table salt
初級|elementary level, beginner level
金魚|goldfish (Carassius auratus)
孝行|filial piety
物指|ruler, measure
生長|growth (of a plant)
広さ|area, extent, dimensions, size
全般|(the) whole
余所|another place, somewhere else, strange parts
話しかける|to address (someone), to accost a person, to talk (to someone)
巡る|to go around, to make a circle around
騙す|to trick, to cheat, to deceive
付き合う|to associate with, to keep company with, to go out with, to go steady with, to get on with
落ち着く|to calm down, to compose oneself, to regain presence of mind, to relax
振る舞う|to behave, to conduct oneself, to act
当てはまる|to apply (of a rule), to be applicable (of standards, lessons, ideas, etc.), to hold true (e.g. of a description), to fit, to be suitable (e.g. of a word), to meet (requirements), to fulfill (conditions), to come under (a heading)
浮かぶ|to float, to be suspended
思い付く|"to think of, to hit upon, to come into one's mind, to be struck with an idea"
矢っ張り|as expected, sure enough, just as one thought
目印|mark (for quick identification or recognition), sign
為す|to form, to make, to constitute
引き受ける|to take on, to undertake, to accept, to take charge of, to assume responsibility for
その上|in addition, furthermore
捕らえる|to catch, to capture, to seize, to arrest, to grab, to catch hold of
追いかける|to chase, to run after, to pursue
替わる|to succeed, to relieve, to replace
零れる|to spill, to fall out of, to overflow
溢れる|to overflow, to brim over, to flood
零す|to spill, to drop, to shed (tears)
漸く|finally, at last
恵まれる|to be blessed with, to be rich in, to abound in
取り出す|to take out, to produce, to pick out
酸っぱい|sour, acid
飛び込む|to jump in, to leap in, to plunge into, to dive
誓う|to swear, to vow, to take an oath, to pledge
蓄える|to store, to save up, to stock up on, to lay in stock, to set aside
蝋燭|candle
目指す|to aim at (for, to do, to become), to try for, to have an eye on
立ち止まる|"to stop (in one's tracks), to come to a stop, to halt, to pause, to stand still"
係わる|to be affected, to be influenced
掘る|to dig, to excavate, to hollow
例える|to compare (something) to, to liken, to speak figuratively, to use a simile, to use a metaphor
嫌がる|to appear uncomfortable (with), to seem to hate, to express dislike
寄越す|to send, to forward
生える|to grow, to spring up, to sprout
妨げる|to disturb, to prevent, to obstruct, to hinder
躊躇う|to hesitate, to waver
点く|to be lit (of a lamp, burner, etc.), to catch fire, to ignite, to start burning
纏める|to collect, to put (it all) together, to integrate, to consolidate, to unify
怠る|to neglect, to be negligent in, to be neglectful of, to fail to do, to leave undone, to avoid (doing), to shirk, to be unmindful of
儲ける|to profit, to get, to earn, to gain
目立つ|to be conspicuous, to stand out
拭く|to wipe, to dry
繋がる|to be tied together, to be connected to, to be linked to
蹴る|to kick
流行る|to be popular, to come into fashion
羨ましい|envious, jealous
騒がしい|noisy, boisterous
有難い|grateful, thankful, welcome, appreciated, evoking gratitude
助かる|to be saved, to be rescued, to survive
銘々|each, individual
潰す|to smash, to crush, to flatten
溶ける|to melt, to thaw, to fuse
憎む|to hate, to detest
大して|(not so) much, (not) very
惨め|miserable, wretched, unhappy, sad, pitiable
存じる|to know, to be aware (of), to be acquainted (with)
味わう|to taste, to savor, to savour, to relish
幾分|somewhat, to some extent, to some degree
温める|to warm (up), to heat (up)
殖やす|to increase, to add to, to augment
大層|very, extremely, exceedingly, greatly, terribly
絶えず|constantly, always, continually, steadily
一休み|(short) rest, breather, break
遡る|to go upstream, to go up (a river)
是非とも|by all means, at all costs, absolutely
足る|to be sufficient, to be enough
泊める|to give shelter to, to lodge, to put up, to accommodate
怪しい|suspicious, dubious, questionable, dodgy, shady, fishy
溜まる|to collect, to gather, to save, to accumulate, to pile up
折角|with trouble, at great pains
独りでに|by itself, automatically, naturally
平気|cool, calm, composed, unconcerned, nonchalant, unmoved, indifferent
物凄い|terrific, staggering, tremendous, incredible, extreme
塞ぐ|to stop up, to close up, to block (up), to plug up, to shut up, to cover (ears, eyes, etc.), to close (eyes, mouth)
仲直り|reconciliation, making up (with), making peace (with), being friends again, patching up a quarrel
掻く|to scratch
混ぜる|to mix, to stir, to blend
喧しい|noisy, loud, clamorous, boisterous
偉い|great, excellent, admirable, commendable, laudable, honorable, wonderful, outstanding, extraordinary
大人しい|gentle, quiet, mild, meek, obedient, docile, well-behaved, tame
空っぽ|empty, vacant, hollow
塞がる|to be closed, to be blocked, to be healed (e.g. wound), to be shut up
引っ掛かる|to be caught in, to be stuck in
比較的|comparatively, relatively
憧れる|to long for, to yearn for, to hanker after, to be attracted by, to be drawn to, to aspire to, to admire, to adore
遠足|school trip, field trip, excursion, outing
見下ろす|to overlook, to command a view of, to look down on
醜い|ugly, unattractive, bad-looking
兎も角|anyhow, anyway, somehow or other, generally speaking, in any case, be that as it may
詫びる|to apologize, to apologise, to make an apology
巻く|to wind, to coil, to roll, to wear (e.g. turban, scarf)
燃やす|to burn
剃る|to shave
照らす|to shine on, to illuminate
忽ち|in an instant, in a moment, immediately, right away, at once
申し訳ない|"I'm sorry, (it's) inexcusable, I feel regretful, I feel guilty"
覗く|to peek (through a keyhole, gap, etc.)
尻尾|tail (of an animal)
崩す|to destroy, to demolish, to pull down, to tear down, to level
裏返す|to turn inside out, to turn the other way, to turn (something) over
怒鳴る|to shout (in anger), to yell
囁く|to whisper, to murmur
厚かましい|impudent, shameless, brazen, cheeky, presumptuous
鈍い|dull (e.g. a knife), blunt
思いがけない|unexpected, contrary to expectations, by chance, casual
突っ込む|to thrust (something) into (something), to cram, to stuff, to shove
撒く|to scatter, to sprinkle, to strew
揃える|to collect, to gather, to get together, to complete (a collection)
冷める|to cool down, to get cold
組み立てる|to assemble, to put together, to set up, to construct, to build, to compose (a story, poem, etc.)
可愛がる|"to be affectionate to, to treat tenderly, to dote on, to show one's love (for), to cherish"
縫う|to sew, to stitch
恋しい|yearned for, longed for, missed
敷く|to spread out, to lay out
独り言|soliloquy, monologue, speaking to oneself
近づける|to bring near, to bring close, to let go near
編む|to knit, to plait, to braid
意地悪|malicious, ill-tempered, unkind, mean, nasty
嗅ぐ|to sniff, to smell
傾く|to incline toward, to slant, to lurch, to heel over, to be disposed to, to trend toward, to be prone to
甘やかす|to pamper, to spoil
擦る|to rub, to scrub, to scrape
真っ青|deep blue, bright blue
済まない|inexcusable, unjustifiable, unpardonable
水平線|horizon (related to bodies of water)
補う|to supplement, to make up for, to compensate for, to cover (a shortage, loss, etc.), to fill (e.g. a vacancy)
曲げる|to bend, to crook, to bow, to curve, to curl
映る|to be reflected, to harmonize with (harmonise), to come out (photo), to be projected, to be displayed (on a screen)
爽やか|fresh, refreshing, invigorating, pleasant, delightful
図々しい|impudent, shameless, brazen, forward, audacious, cheeky
砕ける|to break (into pieces), to be broken, to be smashed
散らかる|to be in disorder, to lie scattered around
含める|to include (in a group or scope)
捕る|to catch (a wild animal, fish, insect, baseball, etc.), to capture
慰める|to comfort, to console, to amuse
至急|urgent, pressing, immediate, prompt, express
生意気|impertinent, saucy, cheeky, impudent, audacious, cocky, pert, brash
固まる|to harden, to solidify
早速|at once, immediately, without delay, promptly
目覚まし|alarm clock
這う|to crawl, to creep, to go on all fours
敬う|to show respect for, to revere, to honour, to honor, to worship, to hold in esteem
必需品|necessities, necessary article, requisite, essentials
改めて|another time, again, over again, once again, anew
返る|to return, to come back, to go back
浮く|to float
承る|to hear, to be told, to know
蒸し暑い|humid, sultry
引き返す|"to turn back, to go back, to come back, to return, to retrace one's steps"
仮定|assumption, supposition, hypothesis
言い出す|to begin to say, to start talking, to broach (a matter), to bring up, to come out with
欠伸|yawn, yawning
出来上がる|to be completed, to be finished, to be ready (e.g. to serve or eat)
何分|some, any, (a) little, of some kind, of some sort
行き成り|abruptly, suddenly, all of a sudden, without warning
各地|every place, various places
下らない|trivial, trifling, insignificant, not worth bothering with, worthless, useless, good-for-nothing
妥当|valid, proper, right, appropriate, reasonable
近寄る|to approach, to draw near
目茶苦茶|absurd, unreasonable, nonsensical, preposterous, incoherent
青白い|pale, pallid
お早う|good morning
転がる|to roll, to tumble
背負う|"to carry on one's back"
険しい|precipitous, rugged, inaccessible, impregnable, steep
逃がす|to set free, to let go, to release
湿る|to become damp, to become moist, to become wet
澄む|to become clear (water, air, etc.), to become transparent
暢気|easy, easygoing, carefree, happy-go-lucky, optimistic, leisurely, careless, thoughtless
但し|but, however, provided that
跳ねる|to jump, to leap, to prance, to spring up, to bound, to hop
お代わり|another helping, second helping, seconds, refill
災難|calamity, misfortune, disaster
宛名|"name and address (on an envelope, etc.), (addressee's) name, addressee"
姪|niece
儲かる|to be profitable, to yield a profit
裂く|to tear, to rip up
痒い|itchy
睨む|to glare at, to scowl at, to glower at
重なる|to be piled up, to lie on top of one another
先ほど|a short while ago, a moment ago, just now, some time ago
照る|to shine
畳む|to fold (clothes, umbrella)
教わる|to be taught, to learn, to take lessons in
甦る|to be resurrected, to be resuscitated, to be rehabilitated, to be revived, to be refreshed, to be restored
薬缶|kettle
通用|(common) use (of a language, currency, etc.), current use, circulation, currency, validity (e.g. of a ticket)
打ち合わせ|(preparatory) meeting, briefing session, (making) advance arrangements
いつの間にか|before one knows, before one becomes aware of, unnoticed, unawares
ご無沙汰|not writing or contacting for a while, neglecting (failing) to write (call, visit, etc.), long silence
何となく|somehow or other, for some reason or another, without knowing why
耕す|to till, to plow, to plough, to cultivate
腰掛ける|to sit (down)
思い込む|to be convinced (that), to be under the impression (that), to feel sure (that), to assume (that)
平凡|ordinary, common, commonplace, mediocre, unremarkable, undistinguished, uneventful
羊毛|wool
溜める|to amass, to accumulate, to store
乾かす|to dry (clothes, etc.), to desiccate
目眩|dizziness, giddiness, vertigo
威張る|"to put on airs, to act big, to throw one's weight about, to be overbearing, to be domineering, to be bossy, to be pushy, to be proud, to be haughty, to be arrogant, to swagger, to boast, to brag"
謎々|riddle, puzzle, enigma
お休み|holiday, day off, absence
溶け込む|to melt into, to dissolve into, to merge into
脱線|derailment
担ぐ|"to shoulder, to carry on one's shoulder"
下品|vulgar, indecent, coarse, crude
速達|express, special delivery
騒々しい|noisy, loud, boisterous, clamorous, raucous
引き止める|to detain, to check, to restrain, to stop
出鱈目|nonsense, irresponsible remark, codswallop, hogwash, rubbish
掃く|to sweep, to brush, to clean
更ける|to get late, to advance, to wear on
尖る|to taper to a point, to become pointed, to become sharp
熱する|to heat, to heat up
目上|superior, superiors, senior
若しかしたら|perhaps, maybe, perchance, by some chance, by any chance
愈々|more and more, all the more, increasingly
ため息|sigh
信ずる|to believe, to believe in, to place trust in, to confide in, to have faith in
真似る|to mimic, to imitate
塩辛い|salty (taste), briny
引力|attraction (e.g. magnetic, gravitation), affinity, gravitational pull
纏まる|to find resolution, to be settled, to be agreed on, to be completed
探る|to feel around for, to fumble for, to grope for, to search for, to look for
短所|defect, demerit, weak point, disadvantage
散らかす|to scatter around, to leave untidy, to make a mess
御洒落|"stylish, fashionable, trendy, chic, smartly dressed, careful about one's appearance"
広める|to spread, to propagate, to popularize, to disseminate
溶かす|to dissolve
重たい|heavy, weighty
護謨|gum, rubber
巫山戯る|to joke, to jest, to kid, to josh
戸棚|cupboard, locker, closet, wardrobe, cabinet
整う|to be ready, to be prepared, to be arranged
交ざる|to be mixed, to be blended with, to associate with, to mingle with, to join
因る|to be due to, to be caused by
濡らす|to wet, to moisten, to dampen, to soak, to dip
煮える|to be boiled, to be cooked
糊|paste, glue
凍える|"to freeze (of one's body), to be frozen, to become numb (with cold), to be chilled"
針金|wire
被せる|to cover (with something)
取り入れる|to harvest, to reap
湧く|to well (up), to gush out (of water), to spring out, to surge
売り切れる|to be sold out
錆びる|to rust, to become rusty
始終|continuously, from beginning to end, from first to last
茂る|to grow thickly, to be in full leaf, to be rampant, to luxuriate, to be luxurious
交じる|to be mixed, to be blended with, to be combined
縮む|to shrink, to contract, to diminish (in size)
末っ子|youngest child
当てはめる|to apply, to adapt
見っともない|shameful, disgraceful, unsightly, indecent, unseemly, unbecoming, improper
汲む|to draw (water), to ladle, to dip up, to scoop up, to pump
偶数|even number
酔っ払い|drunkard
売り切れ|sold-out
お手伝いさん|maid
凸凹|unevenness, roughness, ruggedness, bumpiness
荒い|rough, wild, violent, rude, coarse, harsh, fierce, heavy (e.g. breathing)
交差|crossing, intersection
毛糸|knitting wool, woolen yarn, woollen yarn
吊るす|to hang, to hang up
治める|to rule, to govern, to reign over, to administer, to manage (e.g. a household)
夕立|(sudden, heavy) shower (on a summer afternoon or evening), evening shower
大ざっぱ|rough (estimate, summary, etc.), broad, general, sweeping, loose
散る|to fall (e.g. blossoms, leaves)
片付く|to be put in order, to be put to rights
突き当たる|to run into, to collide with, to crash into, to bump against
拵える|to make, to manufacture
瞼|eyelid
眩しい|dazzling, radiant
帰す|to send (someone) back, to send (someone) home
着々|steadily
毎度|each time, always, often
剥がす|to tear off, to peel off, to rip off, to strip off, to skin, to flay, to disrobe, to deprive of, to detach, to disconnect
所々|here and there, in places
貸間|room to let, room for rent
引っ込む|to draw back, to sink, to cave in
流石|"as one would expect, just as you'd expect (from), just like (someone)"
特売|special sale, bargain sale
濁る|to become muddy, to become cloudy, to become turbid, to become impure (of a liquid or gas)
萎む|to wither (of flowers, dreams, etc.), to wilt, to droop, to shrivel, to fade (away), to sag, to deflate
待ち合わせる|to rendezvous, to meet at a prearranged place and time, to arrange to meet
追い越す|to pass (e.g. car), to overtake
鉄橋|railway bridge, iron bridge
採る|to adopt (a method, proposal, etc.), to take (a measure, course of action, etc.), to decide on
目出度い|happy, auspicious, propitious, joyous
諄い|repetitious, long-winded, tedious, wordy, verbose, insistent, importunate
月日|"time, years, days, (one's) life"
等分|division into equal parts, equal parts
日の入り|sunset
催促|pressing, urging, demanding, demand
散らす|to scatter, to cause a shower of
命ずる|to order, to command
面倒くさい|bothersome, tiresome, bother to do
悔しい|frustrated (over a failure, humiliation or injustice), annoyed, chagrined, (bitterly) disappointed, bitter, vexed, frustrating, annoying, regrettable
不潔|unclean, dirty, unsanitary, filthy
転がす|to roll, to wheel, to trundle, to drive (a car)
道順|route, way, course, directions
熟語|kanji compound
お八つ|between-meal snack
好き好き|matter of taste
真っ黒|pitch black
お帰り|return
長引く|to be prolonged, to drag on, to take a long time, to persist, to linger
衣食住|food, clothing and shelter, necessities of life
方角|direction, way
謙遜|modesty, humility, being humble
幼稚|infancy
ちり紙|tissue paper, toilet paper
欲張り|greed, avarice, covetousness, greedy person
跨ぐ|to step over, to step across, to stride over, to stride across, to cross
撫でる|to stroke, to caress, to brush gently, to pat, to rub
偏る|to lean (to one side), to incline
払い戻す|to repay, to pay back, to refund, to reimburse
組み合わせ|combination, assortment, set
着替え|changing clothes, change of clothes
人造|artificial, man-made, imitation, synthetic
下書き|draft, rough copy
祭日|national holiday, festival day
客間|drawing room, parlor, parlour, guest room
四角|quadrilateral, square
著す|to write, to publish
便箋|writing paper, stationery, notepaper
定休日|regular holiday, fixed day off, regular closing day
伝染|contagion, infection
休講|cancellation (of a lecture, class, etc.)
勘違い|misunderstanding, mistaken idea, wrong guess
慌ただしい|busy, hectic, hurried, rushed
瓶詰め|bottling
感ずる|to feel, to sense
祭る|to deify, to enshrine
払い込む|to deposit, to pay in
勇ましい|brave, valiant, gallant, courageous
射す|to shine
略す|to abbreviate, to omit
引き算|subtraction
物騒|dangerous, unsettled, troubled, disturbed, insecure
腰掛け|seat, bench
朗らか|cheerful, merry, sunny, melodious
四捨五入|rounding (off; a number), rounding half away from zero
扇ぐ|to fan
若しかすると|perhaps, possibly, maybe, by some chance
注す|to pour, to add (liquid), to serve (drinks)
繋がり|connection, link, relationship
生ずる|to produce, to yield, to cause
映す|to project, to reflect, to cast (shadow)
桁|column, beam, girder, crossbeam, spar, yard
載る|to be placed on, to be set on, to be piled on, to be loaded on
畏まりました|certainly!
ご苦労さま|thank you (for your hard work), I appreciate your efforts
湯のみ|teacup
送別|farewell, send-off
小便|urine, piss, pee, urination
損得|loss and gain, advantage and disadvantage
卸す|to sell wholesale
憎らしい|odious, hateful, detestable, horrible
倣う|to imitate, to follow, to copy, to emulate
中性|neutrality (incl. chemical, electrical, etc.), indifference
湯気|steam, vapour, vapor
坊ちゃん|"(another's) son, boy, young master"
炊事|cooking, kitchen work
卑怯|cowardly, craven
一まず|for now, for the time being, for the present
拝む|"to assume the posture of praying, to press the palms and fingers of both hands together, to do reverence (e.g. before a statue of the Buddha), to pay one's respects"
番地|house number, address
占う|"to tell someone's fortune, to divine (the future)"
区切る|to divide, to separate, to partition, to demarcate, to delimit, to mark off
刷る|to print
雑巾|house-cloth, dust cloth
四角い|square, rectangular
俄|sudden, abrupt, unexpected, improvised, hasty, offhand
回数券|coupon tickets, discount tickets, book of tickets
渇く|to be thirsty, to feel thirsty
揉む|to rub, to crumple
饂飩|udon, thick Japanese wheat noodles
縮れる|to be wavy, to be curled, to be frizzled
悠々|quiet, calm, leisurely, composed
純情|pure heart, naivete, innocence
匙|spoon
入れ物|container, case, receptacle
書き取り|writing down from other written material, writing kanji text from hiragana
掛け算|multiplication
差し支え|hindrance, impediment
匂う|to be fragrant, to smell (good)
甚だしい|extreme, excessive, terrible, intense, severe, serious, tremendous, heavy (damage)
図表|chart, diagram, graph, figure
雨戸|sliding storm shutter
水滴|drop of water
頼もしい|reliable, dependable, trustworthy, reassuring
無地|plain, unfigured, patternless, solid (color)
馬鹿らしい|absurd, foolish, stupid, silly, nonsense, ludicrous, preposterous, laughable, ridiculous
紙屑|wastepaper, scrap of paper, paper scraps
お願いします|please
御覧|(please) try to
見かけ|outward appearance
女の人|woman
沁み沁み|keenly, deeply, fully, heartily, seriously, earnestly
引っ繰り返る|to be overturned, to be reversed, to turn over, to capsize
お出掛け|about to start out, just about to leave or go out
やむを得ない|cannot be helped, unavoidable
お先に|before, previously
従姉妹|cousin (female)
田んぼ|paddy field, farm
広々|extensive, spacious
行ってらっしゃい|have a good day, take care, see you
じゃん拳|rock-paper-scissors (game), janken
憎い|hateful, detestable, abominable, vexing, provoking
話し中|busy (phone)
悔やむ|to mourn, to lament
仕上がる|to be finished, to be completed, to be done
坊や|boy, son, child
請う|to beg, to ask, to request, to invite
特長|strong point, forte, merit, strength
焦がす|to burn, to scorch, to singe, to char
挟まる|to get between, to be caught in
飽くまで|to the end, to the bitter end, to the last, stubbornly, persistently, consistently, to the utmost
逆様|inverted, upside down, reversed, back to front, wrong way round
言いつける|to tell (to do), to order, to charge, to direct
通り掛かる|to happen to pass by
バランス|balance
ウール|wool
ダム|dam
鋸|saw
パターン|pattern
赤道|equator
爪|nail (e.g. fingernail, toenail), claw, talon, hoof
平野|plain, open field
小指|little finger, pinky
下線|underline, underscore
墨|sumi, India ink, Chinese ink, ink stick, ink-cake
琴|koto (13-stringed Japanese zither)
その他|the rest, the others
お辞儀|bow, bowing
バケツ|bucket, pail
ブラウス|blouse
モデル|model, dummy, mock-up
ハンドル|handle
ピンク|pink
蓋|cover, lid, cap
ステージ|stage (platform)
ダイヤモンド|diamond
リボン|ribbon
ネックレス|necklace
ヘリコプター|helicopter
マンション|condominium (usu. mid or high-rise), apartment building, apartment house, block of flats, apartment, flat
センチ|centimeter, centimetre
ブラシ|brush
プラットホーム|platform
プログラム|program (of events, music, etc.), programme
アクセント|accent (on a syllable, word), stress, pitch accent
ジャーナリスト|journalist
オーケストラ|orchestra
スタート|start, beginning
カバー|cover, covering, dust jacket, wrapper
チョーク|chalk
ボーナス|bonus
コンクリート|concrete
サラリーマン|office worker, company employee, company man, salaryman
セメント|cement
テーマ|theme, topic, subject matter, motif, project, slogan
ダイヤル|dial (e.g. telephone, radio, clock, gauge)
インタビュー|interview (on television, in a newspaper, etc.)
ビタミン|vitamin
ポスター|poster
シーツ|sheet, bed sheet
カロリー|calorie
リズム|rhythm
サイレン|siren
ロッカー|locker
ナイロン|nylon
キャンパス|campus
フライパン|fry pan, frying pan
コンクール|competition, contest
ファスナー|zip fastener, zipper, zip
オルガン|organ (musical instrument)
テンポ|tempo
マスク|(face) mask
スライド|slide (for projection), transparency
ミシン|sewing machine
レジャー|leisure
レンズ|lens
リットル|litre, liter
アンテナ|antenna
スピーカー|speaker
ストップ|stop
歌留多|karuta, traditional Japanese playing cards, esp. hyakunin isshu karuta or iroha karuta
ミリ|milli-, 10^-3
スマート|smart (clothing, etc.), stylish
シリーズ|series
扇子|folding fan
サンプル|sample, example, specimen
バンド|band
ギャング|gang
ストッキング|stockings
コレクション|collection (of art, stamps, etc.), collecting
イコール|equal, equivalent
コーラス|chorus
エプロン|apron
コース|course, route, trail
サークル|group with a common interest (e.g. students), club (e.g. company sports club), circle
大凡|about, roughly, approximately
目下|subordinate, subordinates, inferior, inferiors, junior
並行|going side-by-side, going abreast
脅かす|to threaten, to menace, to intimidate
紅葉|leaves turning red (in autumn), red leaves, autumn colours, fall colors
羨む|to envy, to be envious of, to be jealous of
大木|large tree
齧る|to gnaw, to nibble, to bite, to munch, to crunch
ひっくり返す|to turn over, to turn upside down, to turn up, to turn inside out, to turn out
日日|date (of a planned event, act, etc.), day
白髪|white hair, grey hair, gray hair
すれ違う|to pass (by) each other, to brush past
父母|father and mother, parents
複数|plural, multiple
放る|to throw, to fling, to hurl, to toss
炙る|"to warm (e.g. one's hands over a fire), to dry"
万歳|banzai, hurray, hurrah, hooray
お目出度い|(matter) for congratulations, worthy of celebration, happy (occasion, ending, etc.), joyous, auspicious
関東|Kantō, region consisting of Tokyo and surrounding prefectures
破く|to tear, to rip
傾らか|gently sloping, gentle, gradual, easy
順々|in order, in turn
茶色い|light brown, tawny
通ずる|to be open (to traffic), to lead to, to communicate (with)
挿す|to insert, to put in
通帳|passbook, bankbook
繋げる|to connect
此間|the other day, lately, recently
点々|here and there, little by little, sporadically, scattered in drops
造船|shipbuilding
見出し|heading, headline, title, caption
団地|multi-unit apartments, apartment complex
調味料|seasoning, flavoring, flavouring, condiment
文芸|literature
濃度|concentration, density
換気|ventilation
防犯|prevention of crime
民謡|folk song, popular song
私鉄|private railway
領事|consul
列島|archipelago, chain of islands
床の間|tokonoma (alcove where art or flowers are displayed)
消毒|disinfection, sterilization, sterilisation
半径|radius
気を付ける|to be careful, to pay attention, to take care
揶揄う|"to tease, to make fun of, to poke fun at, to make a crack about, to chaff, to kid, to joke, to banter, to pull someone's leg"
アイデア|idea
左様なら|farewell, adieu, goodbye, so long
点ける|to turn on, to switch on, to light up
打つかる|to bump into, to run into, to collide with, to hit, to strike
打付ける|"to hit (e.g. one's head), to strike, to knock, to run (into), to crash (into)"
そっと|softly, gently, quietly, lightly
火傷|burn, scald
スケジュール|schedule, program, calendar
うっかり|carelessly, thoughtlessly, inadvertently
ドキドキ|thump-thump, bang-bang, pit-a-pat, pitapat, pitter-patter
彼此|this and that, this or that, one thing or another, this way and that
くっ付く|to adhere to, to stick to, to cling to
プラスチック|plastic
ぶつぶつ|grunt, grumble, complaint, mutter
こっそり|stealthily, secretly, in secret
汚す|to pollute, to contaminate, to soil, to make dirty, to stain
痺れる|to become numb, to go to sleep (e.g. a limb)
メニュー|menu
どうせ|anyhow, in any case, at any rate, after all, at all, no matter what
ニコニコ|with a friendly grin, smilingly
呆れる|to be amazed, to be shocked, to be astonished, to be astounded, to be disgusted, to be exasperated, to be fed up
レベル|level, standard, amount, degree, grade, rank, class
退く|to step aside, to move (i.e. out of the way), to make way
まあまあ|so-so, passable, not (so) bad, reasonable
ピストル|pistol
クリーニング|cleaning, dry cleaning, laundry service
すっきり|"refreshingly, with a feeling of relief, pleasantly, (a weight) off one's shoulder"
ランチ|lunch
コック|cook, chef
ラッシュアワー|rush hour
シーズン|season (period in which regulated games are played)
スチュワーデス|stewardess, (female) flight attendant
疾っくに|long ago, a long time ago, already
凭れる|to lean against, to lean on, to recline on
クーラー|air conditioner
モーター|motor
ロビー|lobby, lounge
嚏|sneeze
メーター|meter, gauge
破れる|to get torn, to tear, to rip, to break, to wear out
潰れる|to be crushed, to be squashed, to be smashed, to be destroyed, to be broken, to collapse
日当たり|exposure to the sun, sunny place
マイナス|minus, subtraction, taking away
ダブル|double
船便|surface mail (ship), sea mail
ぴかぴか|with a glitter, with a sparkle
滑らす|to shift, to move, to slide
トレーニング|training (for a skill, job, sport, etc.), practice
パンツ|underpants, pants, briefs, panties, shorts, knickers
シャッター|(camera) shutter
秤|scales, weighing machine
ベテラン|veteran (in a particular field), person with a lot of experience, old hand
草臥れる|to get tired, to become exhausted, to grow weary
捻る|to twist, to wrench, to turn (a tap, switch, etc.)
狡い|sly, cunning, sneaky, crafty, unfair, dishonest
ビニール|vinyl, plastic
マフラー|(thick) scarf, muffler
プリント|print, printing, (printed) copy
お陰様で|"thankfully, fortunately, luckily, by God's grace, under the gods' shadow"
モダン|modern
くっ付ける|to attach, to stick together, to paste, to glue
レクリエーション|recreation
ぎっしり|tightly (packed), densely, closely, crammed
オートメーション|automation
カセット|cassette (tape)
のろのろ|slowly, sluggishly
フワフワ|lightly (floating, drifting, etc.), buoyantly
そそっかしい|careless, thoughtless, hasty, rash
うろうろ|restlessly, aimlessly, without purpose
めっきり|remarkably, noticeably, considerably, appreciably
ワンピース|dress
冷ます|to cool (e.g. from a high temperature to room temperature), to let cool
エチケット|politeness, good manners, courtesy, etiquette
洒落|joke, pun, jest, witticism, wordplay
ランニング|running
初めに|first, firstly, first of all, to begin with, in the beginning, at the beginning
コンセント|electrical outlet, wall socket, power plug
発条|spring (device)
しゃがむ|to squat, to crouch
スクール|school
ナンバー|number
一通り|generally, in the main, briefly (look over, explain, etc.), roughly, more or less
振り仮名|furigana, kana printed above or next to kanji to indicate pronunciation
襖|fusuma, Japanese sliding screen
五十音|the Japanese syllabary
剃刀|razor
送り仮名|kana written after a kanji to complete the full (usually kun) reading of the word, declensional kana ending
草履|zori, traditional Japanese thonged sandals
符号|sign, mark, symbol, code
分数|fraction
平仮名|hiragana, cursive Japanese syllabary used primarily for native Japanese words (esp. function words, inflections, etc.)
牧畜|stock-farming, livestock farming, cattle breeding
片仮名|katakana, angular Japanese syllabary used primarily for loanwords
三日月|new moon, crescent moon
目次|table of contents, contents
小数|fraction (part of), decimal fraction
整数|integer
緯度|latitude (nav.)
どっと|bursting out (laughter), breaking out (applause), roaring, whooping
えっと|let me see, well, errr ..., uhh ...
せっせと|diligently, assiduously, industriously, beavering away
ウェイトレス|waitress
そう言えば|now that you mention it, come to think of it, that reminds me, on that subject, speaking of which
お大事に|take care of yourself, get well soon
初めまして|"nice to meet you, I'm glad to make your acquaintance, how do you do?"
お待たせしました|thank you for waiting, sorry to have kept you waiting
ずらり|in a row, in a line
楕円|ellipse
スカーフ|scarf (esp. a lightweight summer scarf worn by women)
ガム|chewing gum
オイル|oil, petroleum
ショップ|shop
見慣れる|to become used to seeing, to be familiar with
煎る|to roast, to parch, to toast, to boil down
足袋|tabi, Japanese socks (with split toe)
直流|direct current, DC
加速度|acceleration
同格|the same rank, equality
部首|radical (of a kanji character)
咥える|"to hold in one's mouth"
やっ付ける|to beat, to attack (an enemy), to do away with, to finish off
捩る|to twist, to screw, to wrench
切っ掛け|chance, start, cue, excuse, motive, impetus, occasion
県庁|prefectural office
目安|criterion, standard, yardstick, reference, aim
バイバイ|bye-bye, goodbye
王女|princess
加熱|heating, application of heat
下降|descent, fall, drop, decline, downturn, subsidence
芸能|public entertainment, performing arts
増減|increase and decrease, fluctuation
応接|reception (e.g. of visitors), dealing with
原産|place of origin, habitat
現に|actually, really
個体|individual, specimen
地盤|ground, crust (earth), bed (gravel, river, etc.)
長短|(relative) length
盛る|to serve (in a bowl, on a plate, etc.), to dish out, to dish up, to fill (a bowl) with
出来上がり|completion, finish
田植え|rice planting
投書|letter (e.g. of complaint), letter to the editor, letter from a reader
工員|factory worker
枚数|the number of flat things
農村|agricultural community, farm village
丼|porcelain bowl
差し引き|deduction, subtraction, balance
座敷|tatami room, tatami mat room, formal Japanese room
山林|mountain forest, forest on a mountain, montane forest
産地|producing area
自衛|self-defense, self-defence
問答|questions and answers, dialogue
友好|friendship
一斉|simultaneous, all at once
貯蔵|storage, preservation
間接|indirection, indirectness
初旬|first 10 days of the month
短編|short (e.g. story, film)
水産|aquatic products, fisheries
図形|figure, shape, graphic
歌謡|song, ballad
合理|rationality
集金|money collection
響く|to resound, to be heard far away
だらし無い|slovenly (appearance, work, etc.), sloppy, untidy, undisciplined, careless, loose, slack
緩い|loose
恨む|to bear a grudge against, to resent, to blame, to curse, to feel bitter towards
焚く|to burn, to kindle, to light (a fire), to make (a fire)
吊る|to hang, to suspend, to sling, to wear (e.g. a sword), to put up (e.g. a shelf)
凹む|to be dented, to be indented, to yield, to give, to sink, to collapse, to cave in
円周|circumference
透き通る|to be transparent, to be see-through, to be clear
縮める|to shorten, to reduce, to condense, to shrink
論ずる|to discuss, to talk about, to deal with (a topic)
落とし物|lost property, something dropped and left behind
粗筋|outline, summary, argument
煙い|smoky
涼む|to cool oneself, to cool off, to enjoy the cool air
張り切る|to be in high spirits, to be full of vigor (vigour), to be enthusiastic, to be eager, to stretch to breaking point
四つ角|four corners
ご馳走さま|thank you (for the meal), that was a delicious meal
放れる|to get free (from), to be freed, to be released
句読点|punctuation mark
領収|receipt (of money), receiving
薄める|to dilute, to water down
概論|introduction, outline, general remarks
蒔く|to sow, to plant, to seed
御中|... and Company, Messrs, for the attention of ...
寝巻き|nightclothes, nightwear, sleepwear, pyjamas, pajamas, nightgown, nightdress
溶く|to dissolve (paint), to scramble (eggs), to melt (metal, etc.), to mix (water with flour, etc.)
写生|sketching, drawing from nature, portrayal, description
算盤|abacus, soroban
心当たり|having in mind, happening to know (of), idea (of), inkling
単数|single, one
手拭い|(hand) towel
打ち消す|to deny, to contradict
応ずる|to answer, to respond, to meet
割合に|comparatively
判子|seal (used in lieu of a signature), stamp, chop
仕様が無い|"there's no (other) way"
思い切り|"to one's heart's content, as much as one wants, as hard as one can, with all one's strength, to the best of one's ability, to the utmost, with determination, hard, heavily"
御数|small dish (usu. one of several accompanying rice), side dish
斬る|to kill (a human) using a blade (sword, machete, knife, etc.), to slice (off), to lop (off), to cut (off)
割りと|comparatively, relatively, fairly, rather, pretty, unexpectedly
正味|net (amount), clear, full (e.g. working hours)
専制|despotism, autocracy
夜行|walking around at night, night travel
速力|speed
激増|sharp increase, sudden rise
何々|what
習字|penmanship, calligraphy
耕地|arable land, plantation, farmland
針路|course, direction
養分|nutrient, nourishment
明明後日|"in three days' time, two days after tomorrow"
ブローチ|brooch
斯うして|thus, in this way
潜る|to dive (into or under water)
うんと|a great deal, very much, a lot
お気の毒に|"my sympathies, that's too bad, my condolences"
しゃぶる|to suck, to lick
はきはき|briskly, smartly, promptly, clearly, lucidly
こちらこそ|it is I who should say so
その為|hence, for that reason
形容動詞|adjectival noun (in Japanese), quasi-adjective, nominal adjective, na-, taru-, nari- or tari-adjective
伯父さん|uncle
釜|iron pot, kettle
寒帯|frigid zone
火口|(volcanic) crater, caldera
蒸す|to steam (food, towel, etc.)
述語|predicate
その頃|at that time, in those days, at that moment, then
どうぞ宜しく|pleased to meet you, how do you do
マラソン|marathon, long-distance race
レインコート|raincoat, mackintosh, macintosh, trench coat
ペンチ|"cutting pliers, lineman's pliers, combination pliers"
ローマ字|Latin alphabet, Roman alphabet
チップ|tip, gratuity
フリー|free (of restraint, controls, etc.)
モノレール|monorail
ダイアグラム|diagram
ウーマン|woman
お待ち遠様|"I'm sorry to have kept you waiting"
序|opportunity, occasion, chance
存ずる|to know, to be aware (of), to be acquainted (with)
先々月|month before last
酌む|to pour (sake), to serve, to drink (together)
碗|bowl (ceramic, porcelain)
無沙汰|not writing or contacting for a while, neglecting to write (call, visit, etc.), failing to write (call, visit, etc.), long silence
攻め手|offense, offence, method of attack
洋品店|shop that handles Western-style apparel and accessories
先先週|week before last
店屋|store, shop
斜|diagonal
行ってまいります|"good bye, I'm off, see you later"
逸れる|to turn away, to bear off, to veer away, to swerve from, to miss (e.g. a target)
バック|back, rear
退ける|to put something out of the way, to move (something, someone) aside
カーブ|curve, turn, bend
カラー|color, colour
千切る|to tear to pieces, to tear to shreds, to tear up
ご免ください|may I come in?
臍|navel, belly button
今晩は|good evening
仮名|kana, Japanese syllabary (i.e. hiragana, katakana)
和英|Japanese-English
まごまご|confused, flustered, at a loss
お邪魔します|"please excuse the intrusion, I'm coming in"
テニスコート|tennis court
ビルディング|multi-floor building, multi-storey building, tall building
ゼミ|seminar
言付ける|to have someone send (a message, parcel, etc.), to send (via someone else), to leave (a message) with someone
×|x (mark), cross
ローンチ|launch (of a product, service, etc.)
オーバコート|overcoat
一昨昨日|two days before yesterday, three days back (ago)
佚|being comfortable, relaxing
それなのに|and yet, despite this, but even so, but even then, however, nevertheless, for all that, notwithstanding that
タイア|tire, tyre
お掛け下さい|please sit down, please have a seat
締め切り|deadline, closing, cut-off
割引|discount, reduction, rebate
売れ行き|sales, demand
躓く|to trip (over), to stumble
嵌める|to fit (e.g. a pane into a frame), to insert (e.g. a cork), to fasten (a button)
呉れ呉れも|sincerely, earnestly, wholeheartedly
勿体ない|wasteful, a waste
吃逆|hiccup, hiccough
割り算|division
ぶら下げる|to hang, to suspend, to dangle, to swing, to carry
襤褸|rag, old cloth
宣伝|publicity, advertisement, advertising, propaganda
乾燥|dryness, aridity, drying (e.g. clothes), dehydration, desiccation
角度|angle
寺院|Buddhist temple
楽器|musical instrument
風船|balloon (toy or decoration)
漁師|fisherman
口紅|lipstick
水分|water, liquid, fluid, moisture, humidity, sap, juice
摩擦|friction, rubbing, chafing
文房具|stationery
電流|electric current
鉱物|mineral
代名詞|pronoun
吐き気|nausea, feeling like throwing up, feeling sick
官庁|government office, government agency, authorities
炭鉱|coal mine, (coal) pit, colliery
図鑑|pictorial book, picture book, illustrated reference book, identification manual, field guide
改札|examination of tickets
浴衣|yukata (light cotton kimono worn in the summer or used as a bathrobe)
保健|preservation of health, hygiene, sanitation
預かる|to look after, to take care of, to keep, to hold on to, to keep in custody
余る|to remain, to be left over, to be in excess, to be too many
仲良し|close friendship, close friend, good friend, bosom buddy, chum, pal
狙い|aim
見本|sample, specimen, pattern
挟む|"to hold between (e.g. one's fingers, chopsticks), to grip (from both sides)"
生存|existence, being, life, survival
応援|aid, assistance, help, support, reinforcement
修繕|repair, mending
可決|approval, adoption (of a motion, bill, etc.), passage
呼びかける|to call out to, to hail, to address
輸送|transport, transportation, transit, conveyance
干す|to air, to dry, to desiccate
膨らむ|to expand, to swell (out), to get big, to become inflated
月給|monthly salary
生る|to bear fruit
英文|English writing, English sentence, English text
裏口|backdoor, rear entrance, rear exit
消極的|negative, passive, half-hearted, unmotivated
真っ暗|pitch-dark, pitch-black, completely dark
功績|achievement, meritorious deed, distinguished service, contribution
講師|speaker, lecturer
書留|registered mail, registered post, registration (of mail)
出迎え|meeting, reception
心身|mind and body
手帳|notebook, memo pad, (pocket) diary
危うい|dangerous, in danger, facing imminent danger
重点|important point, emphasis, stress, importance, priority
基盤|base, basis, foundation, footing, infrastructure
敷地|site, plot, lot, grounds
四季|the four seasons
斜め|slanting, tilted, sloping, diagonal, oblique
冷凍|freezing, cold storage, refrigeration
月末|end of the month
警備|defense, defence, guard, policing, security
主役|leading part, leading actor, leading actress
出入り|going in and out, entering and exiting
活字|printing type, movable type
青少年|young people, youth, the younger generation
出勤|going to work, leaving for work, attendance (at work), being at work, presence (in the office), reporting for work
上級|upper level, upper grade, high rank, advanced level, senior level, upper class
当番|"being on duty, person on duty, one's turn"
原始|origin, beginning, genesis
重体|serious condition, critical condition
下旬|last third of a month, 21st to the last day of a month
断水|suspension of water supply, water outage
都心|city centre (esp. of Tokyo), heart of a city, downtown area
直通|direct line, direct communication, connecting directly, through service, nonstop service
国立|national, founded and run by the central government
坊さん|Buddhist priest, monk
要旨|(main) point, gist, key points, essentials, substance, summary, outline, abstract
並木|roadside trees, row of trees
拡充|expansion
却って|on the contrary, rather, instead, all the more
訳す|to translate, to interpret
鳴らす|to ring, to sound, to chime, to beat, to snort (nose), to snap (fingers), to crack (joints)
住まい|dwelling, house, residence, address
焦げる|to burn, to scorch, to char, to singe
静まる|to become quiet, to quiet down, to quieten down
元々|originally, from the start, from the beginning, from the outset, by nature
受け持つ|to take (be in) charge of
実る|to bear fruit, to ripen
惜しい|regrettable, disappointing, unfortunate
着せる|to put clothes on (someone), to dress, to clothe
釣り合う|to balance, to be in harmony, to be in equilibrium
剥く|to peel, to skin, to pare, to hull, to strip
彫る|to carve, to engrave, to sculpt, to chisel
好き嫌い|likes and dislikes, tastes, preferences, pickiness (esp. about food), choosiness, fussiness
炊く|to cook (grains, e.g. rice)
若々しい|youthful, young, young-looking
人通り|pedestrian traffic
砕く|to break (into pieces), to smash, to crush, to shatter, to grind (into powder), to pound
清書|fair copy, clean copy
お参り|visit (to a shrine, grave, etc.), worship
清い|clean, clear
突き当たり|end (of a street, hallway, etc.)
椀|bowl (wooden)
縞|stripe, bar, streak
曲線|curve
地下水|underground water
しつこい|insistent, obstinate, persistent, tenacious
仮名遣い|kana orthography, syllabary spelling
抽象|abstraction
三角|triangle, triangular shape
英和|English-Japanese
高層|high-rise (building), multistory, multistoried, tall
自習|self-study, teaching oneself
作製|manufacture, production
漢和|China and Japan