程|extent, degree, measure
正直|honest, frank, candid, straightforward
一致|agreement, accord, correspondence, consistency, coincidence
博物館|museum
皿|plate, dish, platter, disc
舞台|stage (of a theatre, concert hall, etc.), (stage) performance
寄付|contribution, donation
猿|monkey (esp. the Japanese macaque, Macaca fuscata), ape, non-human primate
平等|equality, impartiality, evenness
金属|metal
左右|left and right, right and left
商人|merchant, trader, tradesman, dealer, shopkeeper
国境|border (between countries), national border
集団|group, mass
根|root (of a plant)
鎖|chain, chains
時|time, hour, moment
元|origin, source, beginning
計画|plan, project, schedule, scheme, program, programme
少年|boy
列車|train, railway train
健康|health
人間|human being, human, person, man, mankind, humankind
結果|result, consequence, outcome, effect
理解|understanding, comprehension, appreciation
少女|girl (usu. between 7 and 17), young lady
事実|fact, truth, reality
食事|meal, dinner
人生|"(one's) life"
母親|mother
行動|action, conduct, behaviour, behavior, mobilization, mobilisation
父親|father
太陽|Sun
幸福|happiness, well-being, joy, welfare, blessedness
政府|government, administration, ministry
経験|experience
責任|duty, responsibility (incl. supervision of staff)
我慢|endurance, patience, perseverance, bearing (with something)
噂|rumour, rumor, report, hearsay, gossip, common talk
道路|road, highway
機械|machine, mechanism
地球|Earth, the globe
秘密|secret, secrecy, confidentiality, privacy
偶然|coincidence, chance, accident, fortuity
情報|information, news, report, intelligence
現在|the present, present time, now
昼食|lunch, midday meal
期待|expectation, anticipation, hope
丘|hill, height, knoll, rising ground
嵐|storm, tempest
運動|exercise, physical training, workout, sports, athletics
大統領|president (of a nation)
演説|speech, address
神|god, deity, divinity, spirit, kami
馬|horse
読書|reading (a book)
詩|poem, poetry, verse
知識|knowledge, information
都市|town, city, municipal, urban
収入|income, earnings, revenue, proceeds, takings, receipts
嘘|lie, fib, falsehood, untruth
詩人|poet
涙|tear, tears, lachrymal secretion
円|yen (Japanese monetary unit)
酒|alcohol, sake
財産|property, fortune, assets
発見|discovery, detection, finding
勇気|courage, bravery, valour, valor, nerve, boldness
患者|patient
学者|scholar, academic, scientist
解決|settlement, solution, resolution
存在|existence, being, presence
言語|language
信頼|trust (in), confidence, faith, reliance
作家|author, writer, novelist, artist
海外|foreign, abroad, overseas
平和|peace, harmony
希望|hope, wish, aspiration
調査|investigation, examination, inquiry, enquiry, survey
地域|area, region, district, locality
気候|climate
愛|love, affection, care
実験|experiment, experimentation
権利|right, privilege
国民|people (of a country), nation, citizen, national
騒音|noise, din
義務|duty, obligation, responsibility
釣り|fishing, angling
胸|chest, breast
過去|the past, bygone days
物価|prices of commodities, prices (in general), cost-of-living
利益|profit, gains
発明|invention
教授|professor
植物|plant, vegetation
氷|ice
石油|oil, petroleum
痛み|pain, ache, soreness, grief, distress
進歩|progress, advance, improvement, development
物語|story, tale, narrative, account, fable, legend
感情|emotion, feeling, feelings, sentiment
週|week
屋根|roof
議長|chair, chairman, chairperson, speaker (of an assembly), president (of a council, senate, etc.)
恐怖|fear, dread, dismay, terror, horror, scare, panic
否定|denial, negation, repudiation, disavowal
商品|commodity, article of commerce, goods, stock, merchandise
費用|cost, expense
作品|work (e.g. book, film, painting, composition), piece, production, opus
賞|prize, award
城|castle
留学|studying abroad
価格|price, value, cost
犯罪|crime, offence, offense
肩|shoulder
意志|will, volition, intention, intent, determination
評価|valuation, appraisal, evaluation, assessment, estimation, rating, judging
正午|noon, midday
職業|occupation, profession, job, vocation, trade, calling, business
家具|furniture
劇場|theatre, theater, playhouse
首相|prime minister, chancellor (Germany, Austria, etc.), premier
不安|anxiety, uneasiness, worry, apprehension, fear, insecurity, suspense
自然|nature
自殺|suicide
意識|consciousness
逮捕|arrest, apprehension, capture
爆発|explosion, detonation, blast, blowing up, eruption
論文|thesis, essay, treatise, paper, article
記録|record, minutes, document
頭痛|headache
世紀|century
契約|contract, compact, agreement
牛|cattle (Bos taurus), cow, bull, ox, calf
精神|mind, spirit, soul, heart, ethos
記憶|memory, recollection, remembrance
優勝|overall victory, championship, winning the title
俳優|actor, actress, player, performer
独立|"independence, self-reliance, supporting oneself, being on one's own"
額|(picture) frame, framed picture
州|state (of the US, Australia, India, Germany, etc.), province (e.g. of Canada), county (e.g. of the UK), region (e.g. of Italy), canton, oblast
公平|fairness, impartiality, justice, objectivity
強盗|robber, mugger
生命|life, existence
霧|fog, mist
記事|article, news story, report, account
命令|order, command, decree, directive
輸入|import, importation, introduction
銃|gun, rifle, small arms
計算|calculation, reckoning, count
医師|doctor, physician
宇宙|universe, cosmos, space
合図|sign, signal, cue
禁煙|abstaining from smoking, quitting smoking
友情|friendship, fellowship, camaraderie
現実|reality, actuality, hard fact
握手|handshake
訓練|training, drill, practice, discipline
攻撃|attack, assault, raid, onslaught, offensive
生物|living thing, organism, creature, life
香り|aroma, fragrance, scent, smell
企業|enterprise, business, company, corporation
方向|direction, orientation, bearing, way
羽|feather, plume, down
役割|part, assigning (allotment of) parts, role, duties
流れ|flow (of a fluid or gas), stream, current
宗教|religion, religious affiliation, belief, faith, creed
芸術|art, the arts
服装|attire, dress, clothes, clothing, costume, garb
広告|advertisement, advertising
個人|individual, private person, personal, private
署名|signature
無料|free (of charge), gratuitous
駐車|parking (a vehicle)
王様|king
証明|proof, testimony, demonstration, verification, certification
現金|cash, ready money, money on hand, currency
宝石|gem, jewel, precious stone
塔|tower, steeple, spire
出版|publication
話題|topic, subject
芝居|play, drama
博士|expert, learned person
保証|guarantee, security, assurance, pledge
競技|game, match, contest
軍隊|armed forces, military, troops
投票|voting, ballot, poll, vote
離婚|divorce
診察|medical examination, checkup, consultation
年寄り|old person, elderly person, senior citizen
心臓|heart
販売|sales, selling, marketing
影|shadow, silhouette, figure, shape
衝突|collision, crash, impact, running into
輸出|export, exportation
平均|average, mean
型|type, style, model, pattern
冒険|adventure, venture
永遠|eternity, perpetuity, permanence, immortality
表情|facial expression, countenance
未来|(distant) future
小屋|hut, cabin, shed, (animal) pen
青年|youth, young man
胃|stomach
畑|field (for growing wheat, fruit, vegetables, etc.), cultivated land, vegetable plot, kitchen garden, plantation
通学|commuting to school, school commute
虎|tiger (Panthera tigris)
改善|betterment, improvement
鉄道|railroad, railway, rail transport
信号|signal, signalling, signaling
雷|lightning, thunder, thunderbolt
中心|center, centre, middle, heart, core, focus, pivot, emphasis, balance
籠|basket (shopping, etc.), hamper, cage
文字|letter (of alphabet), character
放送|broadcasting, broadcast, program, announcement
収穫|harvest, crop, ingathering
観客|spectator, audience
建設|construction, establishment
袋|bag, sack, pouch
睡眠|sleep
節約|economising, saving
毒|poison, toxicant
油|oil
教科書|textbook, coursebook, schoolbook
座席|seat
常識|common sense, good sense, common knowledge, general knowledge, common practice, accepted practice, social etiquette
単位|unit, denomination
郵便|mail service, postal service, mail, post
運|fortune, luck, chance
誕生|birth, creation, formation
労働|manual labor, manual labour, toil, work
家事|housework, domestic chores
観光|sightseeing, tourism
学習|study, learning, tutorial
汗|sweat, perspiration
失業|unemployment
食欲|appetite (for food)
数字|numeral, figure, digit, numeric character
婚約|engagement, betrothal
毛布|blanket
分析|analysis
武器|weapon, arms, ordnance
鉄|iron (Fe)
書斎|study, library, den, home office, reading room
首都|capital (city), metropolis
引用|quotation, citation, reference
砂漠|desert
笑い|laugh, laughter
硬貨|coin
舌|tongue
異常|strangeness, abnormality, disorder
針|needle, pin
位置|place, position, location
監督|supervision, control, superintendence, direction
酸素|oxygen (O)
穀物|grain, cereal, corn
拍手|clapping hands, applause
予算|estimate (of costs), budget
瞬間|moment, second, instant
絶滅|extinction, extermination
対象|target, object (of worship, study, etc.), subject (of taxation, etc.)
速度|speed, velocity, pace, rate
腰|lower back, waist, hips, lumbar region
祭|festival, feast, matsuri
物質|material, substance
奨学金|scholarship, stipend, bursary
谷|valley
黒板|blackboard
泥|mud, slush, (wet) dirt, mire
農業|agriculture
批評|criticism, critique, review, commentary
議会|congress, parliament, diet, legislative assembly
安定|stability, steadiness, consistency, equilibrium, balance, composure
独身|single, unmarried
巣|nest, rookery, breeding place, hive
石炭|coal
農家|farmer, farming family
建築|construction, architecture (of buildings)
大陸|continent
日付|date, dating
活用|practical use, application, making good use of, putting to good use, capitalizing on
吸収|absorption, suction, attraction
体温|body temperature
文明|civilization, civilisation, culture
知事|prefectural governor
金融|finance, financing, credit transacting, loaning of money, circulation of money
消費|consumption, expenditure, spending
信仰|(religious) faith, belief, creed
外交|diplomacy
学期|school term, semester
翼|wing
大臣|cabinet minister
現状|present condition, existing state, status quo, current state
火災|conflagration, fire
理想|ideal, ideals
助手|assistant, helper
居間|living room (Western style), sitting room
筋肉|muscle
鍋|pan, pot, saucepan
作業|work, operation, task
組合|association, union, guild
板|board, plank
腹|abdomen, belly, stomach
悪魔|devil, demon, fiend
金庫|safe, strongbox, cashbox, vault, strongroom
伝統|tradition, convention
旗|flag
資源|resources
岸|bank, coast, shore
宝|treasure
食品|food, food products, foodstuffs
恋人|lover, sweetheart, boyfriend, girlfriend
現象|phenomenon
炎|flame, blaze
温度|temperature
跡|trace, tracks, mark, sign
呼吸|breathing, respiration
哲学|philosophy
登山|mountain climbing, ascending a mountain, ascent
骨折|bone fracture
代理|representation, agency, proxy
知能|intelligence, intellect, brains
鬼|ogre, demon, oni
印刷|printing
梅雨|(East Asian) rainy season (in Japan, usu. from early June to mid-July)
憲法|constitution
裸|nakedness, nudity
航空|aviation, flying
銀|silver (Ag)
相続|succession
大使|ambassador
渋滞|(traffic) congestion, traffic jam, gridlock
弁当|bento, Japanese box lunch
歩道|footpath, walkway, sidewalk, pavement
衛星|(natural) satellite, moon
芽|sprout, shoot, bud
模様|pattern, figure, design
医療|medical care, medical treatment
栄養|nutrition, nourishment
免許|license, licence, permission, permit, certificate
会計|accounting, finance, account, reckoning
墓|grave, gravesite, tomb
地下|underground, below the ground
議員|member of an assembly, member of the Diet, member of parliament, member of Congress
缶|can, tin
差別|distinction, differentiation, discrimination
笛|flute, fife, pipe, recorder, flageolet, shakuhachi, clarinet
道徳|morals, morality
筋|muscle, tendon, sinew
資本|funds, capital
湾|bay, gulf, inlet
国語|national language
豆|legume (esp. edible legumes or their seeds, e.g. beans, peas, pulses), bean, pea
礼|thanks, gratitude
筆|writing brush, paintbrush, pen
作曲|composition (of music), setting, writing music
土産|local specialty or souvenir bought as a gift while travelling
粉|flour, meal, powder, dust
句|section (i.e. of text), sentence, passage, paragraph
茶|tea
刀|sword (esp. Japanese single-edged), katana
菓子|confectionery, sweets, candy, cake
熱帯|tropics
泡|bubble, foam, froth, suds, lather, head (on beer)
電子|electron
飯|cooked rice
梅|Japanese apricot (Prunus mume), Japanese plum, ume, Chinese plum
能|talent, gift, function
月|Moon
馬鹿|idiot, moron, fool
屡々|often, again and again, frequently, repeatedly
退屈|tedious, boring, dull, uninteresting, tiresome, monotonous
流れる|to stream, to flow (liquid, time, etc.), to run (ink)
暗記|memorization, memorisation, learning by heart
兎|rabbit, hare, coney, cony, lagomorph (esp. leporids)
鼠|mouse, rat
膝|knee
頬|cheek (of the face)
餌|(animal) feed, fodder, pet food
量|quantity, amount, volume, capacity, portion (of food)
莫大|vast, huge, immense, enormous, colossal
式|way, style, fashion, method, system, form, type
紐|string, cord
連想|association (of ideas), being reminded (of something), suggestion
地平線|horizon (related to land)
場|place, spot, space
動詞|verb
袖|sleeve
灰|ash, ashes
秒|second (unit of time)
県|prefecture (of Japan), county (of China, Taiwan, Norway, etc.), department (of France), province (of Italy, Spain, etc.)
帯|obi (kimono sash)
と|if, when
外出|"going out, outing, leaving (one's home, office, etc.)"
当時|at that time, in those days
案内|guidance, leading (the way), showing around
地方|district, region, area, locality
一方|one (esp. of two), the other, one way, the other way, one direction, the other direction, one side, the other side, one party, the other party
発展|development, growth, expansion, extension, flourishing
双子|twins, twin
団体|group, party, team
夜中|middle of the night, dead of night
中央|centre, center, middle, heart
共同|cooperation, collaboration, association, partnership, (acting in) unison
通り|street, road, avenue, thoroughfare
埃|dust
事|thing, matter
欧羅巴|Europe
彼ら|they, them
我々|we
成功|success, achievement
何か|something, some, any
尻|buttocks, behind, rump, bottom, hips
出発|departure, leaving, setting off
起こる|to occur, to happen
考え|thinking, thought, view, opinion, concept
何も|(not) anything, (nothing) at all, (not) any, nothing
友人|friend
努力|effort, exertion, endeavour, endeavor, hard work, striving
終える|to finish
最も|most, extremely
素晴らしい|wonderful, splendid, magnificent
運転|operation (of a machine), running, working
重要|important, essential, significant, major, key, principal
助ける|to save, to rescue, to spare
幸せ|happiness, good fortune, luck, blessing
心配|worry, concern, anxiety, uneasiness, fear
感じる|to feel, to sense, to experience
提案|proposal, proposition, suggestion
出席|attendance, presence, appearance
他人|another person, other people, others
以前|before, prior to, ago
間違い|mistake, error, blunder
価値|value, worth, merit
突然|abrupt, sudden, unexpected
賛成|approval, agreement, support, favour, favor
愛する|to love
老人|old person, senior citizen, the aged, the elderly
到着|arrival
満足|satisfaction, contentment, gratification
氏|Mr, Mrs, Ms, Miss
守る|to protect, to guard, to defend
失う|to lose
只|ordinary, common, usual
下さる|to give, to confer, to bestow
方法|method, process, manner, way, means, technique
無駄|futility, waste, uselessness, pointlessness, idleness
援助|assistance, aid, support
合格|passing (an exam), pass, success, passing grade
許す|to permit, to allow, to approve, to consent to
帰宅|returning home, going home, coming home, getting home
世話|care, looking after, help, assistance, aid
会合|meeting, assembly, gathering
事件|event, affair, incident, case, plot, trouble, scandal
お前|you
議論|argument, discussion, dispute, controversy
困難|difficulty, hardship, trouble, distress
決心|determination, resolution
要求|demand, firm request, requisition, requirement, desire
駄目|no good, not serving its purpose, useless, broken
受け取る|to receive, to get, to accept
休暇|holiday, day off, furlough, absence (from work)
結局|after all, in the end, ultimately, eventually
激しい|violent, furious, tempestuous
尊敬|respect, esteem, reverence, honour, honor
大いに|"very, very much, greatly, considerably, highly, exceedingly, a great deal, a lot, to one's heart's content"
準備|preparation, arrangements, getting ready, provision, setup, reserving
全然|(not) at all, (not) in the slightest
滞在|stay, sojourn
参加|participation, joining, entry
扱う|to deal with (a person), to treat, to handle, to take care of, to entertain
現れる|to appear, to come in sight, to become visible, to come out, to embody, to materialize, to materialise
離れる|to be separated, to be apart, to be distant
実行|execution (e.g. of a plan), carrying out, (putting into) practice, action, implementation, fulfillment, realization
貧しい|poor, needy
出来るだけ|as much as one can, as much as possible, if at all possible
偉大|great, grand, magnificent, outstanding, mighty
望む|to desire, to want, to wish for, to hope for
修理|repair, mending, fixing, servicing
誤り|error, mistake, slip, bug
目的|purpose, goal, aim, objective, intention
感謝|thanks, gratitude, appreciation, thankfulness
示す|to (take out and) show, to demonstrate, to tell, to exemplify, to make apparent
全員|all members, all hands, everyone, everybody, whole crew
相手|companion, partner, company
教師|teacher (classroom)
人気|popularity, public favor
招待|invitation
黙る|to be silent, to say nothing
完全|perfect, complete
出会う|to meet (by chance), to come across, to run across, to encounter, to happen upon
辺り|(in the) neighbourhood, neighborhood, vicinity, nearby, surroundings
実際|reality, actuality, truth, fact, actual conditions
冗談|joke, jest, funny story
歌手|singer
能力|ability, faculty
才能|talent, ability
自慢|pride, boast
敵|opponent, rival, adversary
選手|player (of a sport), athlete, team member
一体|(what) the heck, (why) in the world, (who) on earth
更に|furthermore, again, after all, more and more, moreover, even more
素敵|lovely, wonderful, nice, great, fantastic, superb, cool
回復|restoration, recovery, rehabilitation, return, improvement
熱心|zealous, enthusiastic, ardent, fervent, keen, eager
判断|judgment, judgement, decision, conclusion, adjudication
訪問|call, visit
注文|order (for an item)
態度|attitude, manner, behaviour, demeanour, bearing
給料|salary, wages, pay
既に|already
次第|depending on
決定|decision, determination
影響|influence, effect, impact
年齢|age, years
主張|claim, insistence, assertion, advocacy, emphasis, contention, opinion, tenet
正確|accurate, correct, precise, exact
便り|news, tidings, information, correspondence, letter
信用|confidence, trust, faith, reputation
土地|plot of land, lot, soil
旅|travel, trip, journey
商売|trade, business, commerce
奪う|to take (by force), to take away, to snatch, to steal, to rob (someone) of, to dispossess of, to deprive of, to usurp
苦労|trouble, hardship, difficulty, labour, labor, toil, pains
喜び|joy, delight, rapture, pleasure, gratification, rejoicing, congratulations, felicitations
提出|presentation (of documents), submission (of an application, report, etc.), production (e.g. of evidence), introduction (e.g. of a bill), filing, turning in
姿|figure, form, shape
回|counter for occurrences
好む|to like, to prefer
不足|insufficiency, deficiency, shortage, lack, scarcity, deficit
明らか|clear, obvious, evident, plain, definite
状況|state of affairs, situation, conditions, circumstances
話し合う|to discuss, to talk together
追いつく|to catch up (with), to draw level, to pull even, to reach
邪魔|hindrance, obstacle, nuisance, disturbance, interruption, interference
変化|change, variation, alteration, mutation, transition, transformation, transfiguration, metamorphosis
万一|(unlikely event of) emergency, the worst(-case scenario), 10000 to 1
書類|document, papers
単語|word, vocabulary
恐れる|to fear, to be afraid of
最高|best, supreme, wonderful, finest
種類|variety, kind, type, category
事態|situation, (present) state of affairs, circumstances
幸運|good luck, fortune
週間|week
越える|to cross over, to cross, to pass through, to pass over (out of), to go beyond, to go past
得意|satisfaction, pride, triumph, elation
調子|tune, tone, key, pitch, time, rhythm
状態|state, condition, situation, appearance, circumstances
以来|since, henceforth
成長|growth, development, growing up, becoming an adult
必ずしも|(not) always, (not) necessarily, (not) entirely, (not) all
光景|scene, spectacle, sight, view
頼る|to rely on, to depend on, to count on, to turn to (for help)
残す|to leave (behind)
隠す|to hide, to conceal
恐ろしい|terrible, dreadful, terrifying, frightening
戦う|to make war (on), to wage war (against), to go to war (with), to fight (with), to do battle (against)
実は|as a matter of fact, by the way, to tell you the truth, to be honest, frankly
誇り|pride, boast, credit (to)
常に|always, constantly
性格|character (of a person), personality, disposition, nature
容易|easy, simple, plain
借金|debt, loan, liabilities, borrowing money
中止|interruption, discontinuance, suspension, stoppage
一言|single word, a few words, brief comment
達する|to reach, to get to, to arrive at
地位|(social) position, status, standing
天候|weather
乗客|passenger
罪|crime, sin, wrongdoing, indiscretion
勝ち|win, victory
一層|even more, still more, all the more, more than ever
立場|position, situation
再び|again, once more, a second time
備える|to furnish with, to equip with, to provide, to install
職|job, work, employment, occupation, position
命|life, life force
不思議|wonderful, marvelous, strange, incredible, amazing, curious, miraculous, mysterious
欠席|absence, non-attendance
環境|environment, surroundings, circumstances
傾向|tendency, trend, inclination
燃える|to burn, to get fired up
是非|certainly, without fail
出身|"one's origin (e.g. city, country, parentage, school)"
覆う|to cover, to hide, to conceal, to wrap, to disguise
供給|supply, provision
手段|means, way, measure
感動|being deeply moved emotionally, excitement, passion, inspiration, deep emotion, strong impression
不幸|unhappiness, sorrow, misfortune, disaster, accident
断る|to refuse, to reject, to dismiss, to turn down, to decline
感じ|feeling, sense, impression
乗せる|to place on (something)
先日|the other day, a few days ago
表現|expression, representation, description
無視|disregarding, ignoring
奇妙|strange, odd, peculiar, queer, curious
支払う|to pay
余裕|surplus, margin, leeway, room, space, time, allowance, flexibility, scope
変更|change, modification, alteration, revision, amendment
違い|difference, distinction, discrepancy
合わせる|to match (rhythm, speed, etc.)
美人|beautiful woman, (a) beauty
実現|implementation (e.g. of a system), materialization, materialisation, realization, realisation, actualization, actualisation
殺す|to kill, to slay, to murder, to slaughter
雇う|to employ, to hire, to take on
仲間|companion, fellow, friend, mate, comrade, partner, colleague, coworker, associate
無事|safety, security, peace, quiet
成績|results, record, grades, marks
発表|"announcement, publication, presenting, statement, communique, making known, breaking (news story), expressing (one's opinion), releasing, unveiling"
様々|various, varied, diverse, all sorts of
恐らく|"probably, (most) likely, in all likelihood, I suspect, I dare say, I'm afraid"
歓迎|welcome, reception
全体|whole, entirety
許可|permission, approval, authorization, license
製品|manufactured goods, finished goods, product
疑う|to doubt, to distrust, to be suspicious of, to suspect
大部分|most part, greater part, majority
想像|imagination, supposition, guess
通す|to stick through, to force through
動かす|to move, to shift, to stir, to budge, to change position
完成|completion, perfection, accomplishment
女優|actress, female actor
最終|last, final, closing
便|flight (e.g. airline flight), trip (e.g. train trip), service
物事|things, everything
増加|increase, rise, growth, addition, increment
経営|management, administration, operation, running (a business), conducting
唯一|only, sole, unique
関心|concern, interest
救う|to rescue from, to help out of, to save
横断|crossing (a road, river, etc.), cutting through (e.g. of a river through a town), cutting across, intersecting (e.g. a railway track)
現代|present age, present day, today
支払い|payment
際|occasion, time, circumstances, (in) case (of), when
育つ|to be raised (e.g. child), to be brought up, to grow (up)
婦人|woman, lady, adult female
相談|consultation, discussion, discussing, asking (someone) for advice
考慮|consideration, taking into account
活動|activity (of a person, organization, animal, volcano, etc.), action, operation
王|king, ruler, sovereign, monarch
貯金|putting money aside, savings, deposit (e.g. in a bank)
恋|(romantic) love
結論|conclusion (of an argument, discussion, study, etc.)
命じる|to order, to command
出来事|incident, affair, happening, event
劇|drama, play
見送り|seeing (someone) off, send-off
分ける|to divide (into), to split (into), to part, to separate, to divide up, to classify, to sort out, to divide out
文句|complaint, grumbling, objection
人類|mankind, humanity
協力|cooperation, collaboration, help, support
桜|cherry tree, cherry blossom
人物|person, character, figure, personage, man, woman
望み|wish, desire, hope
食料|food
確かめる|to make sure, to check, to ascertain, to confirm, to verify
略|almost, roughly, approximately, about, around
使用|use, application, employment, utilization, utilisation
愛情|love, affection
処理|processing, dealing with, treatment, disposition, disposal
癖|habit (usu. a bad one), tendency
一生|whole life, a lifetime, all through life, one existence, a generation, an age, the whole world, the era
確認|confirmation, verification, validation, review, check, affirmation, identification
加える|to add, to add up, to sum up, to append, to annex
部分|portion, section, part
当てる|to hit
報告|report, information
日曜|Sunday
同様|same, similar, (just) like, equal
眺める|to look at, to gaze at, to watch, to stare at
直ちに|at once, immediately, right away, without delay
可能|possible, potential, practicable, feasible
画家|painter, artist
高価|highly priced, expensive, valuable, costly
様子|state (of affairs), situation, circumstances
禁止|prohibition, inhibition, ban
深刻|serious, severe, grave, acute
頂上|top, summit, peak
被害|(suffering) damage, injury, harm
手術|surgery, operation, procedure
誤解|misunderstanding
傷|wound, injury, cut, gash, bruise, scratch, scrape, scar
警告|warning, caution, admonition
夫婦|married couple, husband and wife, man and wife
穴|hole, opening, orifice, perforation
誘う|to invite, to ask (someone to do), to call (for), to take (someone) along
専攻|major subject, special study
抱える|"to hold in one's arms, to carry in one's arms, to carry under one's arm, to hold (one's head) in one's hands"
用いる|to use, to make use of, to utilize, to utilise
重大|serious, important, significant, grave, weighty
慎重|careful, cautious, prudent, discreet, deliberate
評判|reputation, (public) estimation, popularity
暮らし|(way of) life, living, livelihood, life circumstances
目標|goal, target, aim, objective
犯人|offender, criminal, culprit
瓶|bottle, jar, decanter, flagon, phial, vial
夫人|wife, Mrs, madam
味方|friend, ally, supporter
繰り返す|to repeat, to do something over again
交換|exchange, interchange, switching, reciprocity, barter, substitution, replacement, clearing (of checks, cheques)
今回|this time, now
損害|damage, injury, loss
好み|liking, taste, fancy, fondness
親しい|close (e.g. friend), familiar, friendly, intimate
語る|to talk about, to speak of, to tell, to narrate
骨|bone
演奏|musical performance
相当|corresponding to (in meaning, function, etc.), being equivalent to
限る|to restrict, to limit, to confine
例|example, instance, illustration, case
幸い|happiness, blessedness, luck, fortune, felicity
料金|fee, charge, fare
世の中|society, the world, the times
事情|circumstances, conditions, situation, reasons, state of affairs
列|row, line, file, column, queue, rank, procession
不自由|discomfort, inconvenience
条件|condition, term, requirement, qualification, prerequisite
破る|to tear, to rip, to break, to destroy
戦い|battle, war, fight, conflict
内容|contents, content, substance, matter, detail, import
言わば|so to speak, so to call it, as it were
減る|to decrease (in size or number), to diminish, to abate
程度|degree, amount, grade, standard, of the order of (following a number), about, approximately
本物|genuine article, real thing, real deal
従って|therefore, consequently, accordingly
不満|dissatisfaction, discontent, displeasure, complaint, unhappiness
次々|in succession, one by one
数える|to count, to enumerate
役|role, assignment, responsibility, duty, function, job, service
芝生|lawn, grass
会員|member, the membership
都会|city
岩|rock, boulder
区別|distinction, differentiation, discrimination, difference
回す|to turn, to rotate, to spin, to twist, to gyrate
豊か|abundant, plentiful, rich, ample
失望|disappointment, despair
面倒|trouble, bother
急速|rapid (e.g. progress)
計る|to measure, to weigh, to survey, to time (sound, gauge, estimate)
裏切る|to betray, to turn traitor (to), to double-cross, to go back on, to be unfaithful (to)
新鮮|fresh
組織|organization, organisation, formation
製造|manufacture, production
批判|criticism, judgement, judgment, comment
検査|inspection (e.g. customs, factory), examination, test, check, scan (e.g. MRI, PET), audit
残り|remainder, remnant, the rest, what is left, balance, leftovers
加わる|to be added to, to be appended
税金|tax, duty
今後|from now on, hereafter
塀|wall
手伝い|helper, assistant
比較|comparison
豊富|abundant, plentiful, rich, ample
願い|desire, wish, hope
有利|advantageous, favourable, better, stronger
少々|just a minute, small quantity
新た|new, fresh, novel
株|stock, share
快適|pleasant, agreeable, comfortable
働き|work, labor, labour
勘定|calculation, computation, counting, reckoning, count
息|breath, breathing
結ぶ|to tie, to bind, to link
直接|direct, immediate, personal, firsthand
構成|composition, construction, formation, makeup, structure, organization, organisation
応じる|to respond, to satisfy, to accept, to comply with, to apply for
苦手|poor (at), weak (in), not very good (at)
追う|to chase, to run after, to pursue, to follow after
謎|riddle, puzzle, enigma, mystery
刈る|to cut (grass, hair, etc.), to mow, to clip, to trim, to prune, to shear, to reap, to harvest
検討|consideration, examination, investigation, study, scrutiny, discussion, analysis, review
組む|to cross (legs or arms), to link (arms)
解釈|interpretation, explanation, reading, construction
絶対|absolutely, definitely, unconditionally
別に|(not) particularly, (not) especially, (not) specially
害|injury, harm, evil influence, damage
握る|to clasp, to grasp, to grip, to clutch
思想|thought, idea, ideology
選択|choice, selection, option
冷静|calmness, composure, coolness, serenity, presence of mind
髪の毛|hair (on the head), (a) hair
魅力|charm, fascination, glamour, glamor, attraction, appeal
飛び出す|to jump out, to rush out, to fly out
共に|together, jointly
確実|certain, sure, definite, reliable, sound, solid, safe, secure
減らす|to abate, to decrease, to diminish, to shorten
需要|demand, request
悩む|to be worried, to be troubled
悲しむ|to be sad, to mourn for, to regret
時期|time, season, period, phase, stage
適切|appropriate, suitable, fitting, apt, proper, right, pertinent, relevant
汚染|pollution, contamination
作物|crop, crops, (agricultural) produce, farm products
注目|notice, attention, observation
観察|observation, survey, watching
祝う|to celebrate, to congratulate, to observe (a festival)
不利|disadvantage, handicap, unfavorable position
主要|chief, main, principal, major
周囲|surroundings, environs
答案|examination paper, examination script, answer sheet
休憩|rest, break, recess, intermission
姉妹|sisters
支配|rule, domination, control
覚悟|readiness, (mental) preparedness
鋭い|sharp (knife, claws, etc.), pointed
代表|representation, representative, delegate, delegation
可哀相|poor, pitiable, pathetic, pitiful
集中|"concentration (on a task), focusing one's attention"
何で|why?, what for?
注ぐ|to pour (into)
換える|to replace, to convert, to change
試す|to try (out), to have a try (at), to test, to put to the test
嫌う|to hate, to dislike, to loathe
贈る|to give (as a gift), to present
混雑|congestion, crush, crowding, jam
配達|delivery
順調|favourable, favorable, doing well, OK, all right
小包|parcel, package
優秀|superior, excellent, brilliant, outstanding
混乱|disorder, chaos, confusion, mayhem
分野|field, sphere, realm, division, branch
書物|book, volume
就職|finding employment, getting a job
印|mark, sign
玉|ball, sphere, globe, orb
永久|eternity, permanence, perpetuity
軍|army, armed forces, troops
景気|business conditions, the market, economic activity, economic climate
多少|a little, some, somewhat, slightly, to some degree, to some extent
時刻|time, (the) hour
主義|doctrine, rule, principle, -ism
講演|lecture, address, speech
親友|close friend, bosom friend, buddy, crony, chum
国会|National Diet, legislative assembly of Japan (1947-)
外す|to remove, to take off, to detach, to unfasten, to undo
記入|entry (in a form, register, diary, etc.), filling in, filling out
衣服|clothes
納得|consent, agreement, acceptance
適用|applying (e.g. a technology), adoption
合計|sum total, total amount
質|quality, value
管理|control, management (e.g. of a business)
戻す|to put back, to return, to give back, to restore (to a previous state, e.g. defrosting, reconstituting, reconciling), to turn back (e.g. clock hand)
承知|knowledge, awareness
食卓|dining table
思い出|memories, recollections, reminiscence
身長|height (of body), stature
制限|restriction, restraint, limitation, limit
大半|majority, more than half, most (of)
布|cloth, fabric, material, textile
尊重|respect, esteem, regard
効果|effect, effectiveness, efficacy, result
肌|skin
範囲|extent, scope, sphere, range, span
皮|skin, hide, pelt, fur
別れ|parting, separation, farewell
論争|dispute, controversy, debate, argument, taking issue
維持|maintenance, preservation, improvement
苦痛|pain, agony, suffering, distress, torment
感心|admiration, being impressed
穏やか|calm, quiet, gentle, peaceful, mild
克服|conquest (of a difficulty, illness, crisis, etc.), overcoming, surmounting, bringing under control
障害|obstacle, impediment, hindrance, barrier, difficulty
年代|age, era, period, date
試し|trial, test
移動|movement, transfer, migration, removal, travel
科目|(school) subject, curriculum, course
明確|clear, precise, definite, distinct
脇|"armpit, under one's arm, side, flank"
承認|recognition, acknowledgement, acknowledgment, approval, consent, agreement
貢献|contribution (furthering a goal or cause), services (to a cause)
緊張|tension, strain, nervousness, stress
著者|author (usu. of a particular book), writer
底|bottom, sole
陽気|cheerful, jovial, merry, lively
順番|turn (in line), order of things, sequential order
度々|often, again and again, over and over again, repeatedly, frequently
金銭|money, cash
経由|going through, going via, going by way of
要するに|in short, in a word, to sum up, to put it simply, to make a long story short, after all
気温|(air) temperature
記者|reporter, journalist
共通|common, shared, mutual
風景|scenery, scene, landscape, view, sight
保存|preservation, conservation, storage, maintenance
期間|period, term, interval
巨大|huge, gigantic, enormous
引っ張る|to pull, to draw, to pull tight
独特|peculiarity, uniqueness, characteristic
軒|eaves
日光|sunlight, sunshine, sunbeams
同僚|coworker, co-worker, colleague, associate
発達|development, growth
表面|surface, face
関連|relation, connection, relevance
一般|general, universal
引退|retirement
開始|start, commencement, beginning, initiation
損|loss, damage, harm, unprofitable
代金|price, cost, charge, payment, bill, fee
見舞い|"visit (to someone affected by illness or misfortune), call, inquiry (about someone's health), expression of sympathy"
家賃|rent
付き合い|association, socializing, socialising, fellowship
月曜|Monday
技師|engineer, technician
小麦|wheat
思わず|unconsciously, involuntarily, instinctively, reflexively, spontaneously, unintentionally, in spite of oneself
後者|the latter, the second
通過|passing through (a tunnel, station, town, etc.), passing by (e.g. of a typhoon), transit
男子|boy
差|difference, variation
温暖|warm, mild, temperate
食糧|food (esp. staple food such as rice or wheat), provisions, rations, food supply
泳ぎ|swimming
住民|inhabitant, resident, citizen, population
請求|claim, demand, charge, application, request, billing (for a service)
真っ赤|bright red, deep red, flushed (of face)
九|nine, 9
前進|advance, moving forward, progress
化粧|make-up, makeup, cosmetics
支度|preparation, arrangements
上京|going (up) to the capital, going to Tokyo
女子|woman, girl
救助|relief, aid, rescue
学問|study, scholarship, learning, education, knowledge
徹夜|staying up all night
王子|prince
見解|opinion, point of view
非常|emergency
単に|simply, merely, only, solely
流す|to drain, to pour, to run, to let flow, to flush, to shed (blood, tears), to spill
抵抗|resistance, opposition, standing up to
破産|bankruptcy, insolvency
単純|simple, plain, uncomplicated, straightforward, simple-minded, naive
疲れ|tiredness, fatigue
意外|unexpected, surprising
機能|function, facility, faculty, feature
印象|impression
笑顔|smiling face, smile
棒|pole, rod, stick, baton
積極的|positive, assertive, active, proactive, aggressive
虫歯|tooth decay, cavity, decayed tooth, dental caries
適度|moderate (degree), proper (amount), temperate, suitable
単なる|mere, simple, sheer
操作|operation, management, handling
重視|regarding as important, attaching importance to, taking a serious view of, putting emphasis on
雰囲気|atmosphere, mood, ambience, ambiance, aura, feel
宿泊|accommodation, lodging
刺激|stimulus, stimulation, irritation (esp. of the body, e.g. skin, eyes)
場面|scene, setting, place (where something happens), scenario, case
実施|enforcement, implementation, putting into practice, carrying out, operation, working (e.g. working parameters), enactment
夜明け|dawn, daybreak
両替|change, money exchange
前者|the former, the first
金額|amount of money, sum of money
倒す|to throw down, to bring down, to blow down, to fell, to knock down, to set (something) down on its side, to turn (something) on its side, to recline (e.g. a seat)
苦しい|painful, difficult, tough, hard
勤め|service, duty, business, responsibility, task
大会|mass meeting, convention, rally, conference, assembly, gathering
一瞬|instant, moment, for an instant
妙|strange, weird, odd, curious
仲|relation, relationship
入場|entrance, entering, admission, admittance
死亡|death, dying, mortality
支出|expenditure, disbursement, expenses
主婦|housewife, mistress (of the house), homemaker
症状|symptoms, condition (of a patient)
一時|"one o'clock"
半ば|middle, halfway, midway
演技|acting, performance
粗末|crude, rough, plain, humble, shabby, poor-quality, low-quality
成人|adult, grownup
格好|shape, form, figure, posture, pose
設計|plan, design, layout
欠陥|defect, fault, flaw, deformity, deficiency, shortage, gap
交際|company, friendship, association, society, acquaintance
材料|materials, ingredients
農民|farmer, peasant
活気|energy, vigour, vigor, liveliness, spirit, life, animation
進学|advancing to the next stage of education, going on to (high school, college, etc.)
特徴|feature, trait, characteristic, peculiarity, distinction
委員|committee member
不正|injustice, unfairness, wrongdoing, iniquity, impropriety, irregularity, dishonesty, illegality, fraud
住宅|residence, housing, residential building
生き物|living thing, living creature, animal, life
地区|district, section, sector
依頼|request, commission, entrusting (with a matter)
完了|completion, conclusion
急激|sudden, abrupt, rapid, sharp, drastic, radical
支店|branch office, branch store
党|party (political)
生地|cloth, fabric, material, texture
推薦|recommendation, referral, endorsement
最低|least, lowest, minimum
審判|judgement, judgment, decision, verdict, sentence
礼儀|manners, courtesy, etiquette
幅|width, breadth
課|lesson
拡大|expansion, extension
装置|equipment, device, installation, apparatus
支給|provision, supply, payment, allowance, grant
厄介|trouble, burden, nuisance, bother, worry
整理|sorting, arrangement, organization, putting in order, adjustment, regulation
収める|to put (into), to put away (in), to put back (in), to keep (in), to store (in), to restore (to its place)
記念|commemoration, celebration, remembrance, memory, honoring the memory of
予期|expectation, anticipation, forecast
基本|basics, fundamentals, basis, foundation
刑事|(police) detective
発行|publication (of a newspaper, magazine, book, etc.), issue
設備|equipment, facilities, installation, accommodations, conveniences, arrangements
全国|the whole country
読み|reading
本人|the person in question, the person themselves, said person
級|(school) grade, year, class
長期|long-term
正式|formal, official, regular, proper, legal, due (formalities)
豪華|extravagant, lavish, opulent, luxurious, magnificent, splendid, fancy, gorgeous
微妙|subtle, delicate, fine
年月|months and years
続き|continuation, rest (of the story, work, etc.), next installment, sequel
決まり|rule, regulation
掲示|notice, bulletin, post, posting, placard
迎え|meeting, greeting, welcome
券|ticket, coupon, bond, certificate
語学|study of foreign languages
強力|powerful, strong
愉快|pleasant, delightful, enjoyable, joyful, cheerful, amusing, happy
裁判|trial, judgement, judgment
幕|curtain
向い|facing, opposite, across the street, other side
水準|level, standard
敬意|respect, honour, honor
図|drawing, picture, diagram, figure, illustration, chart, graph, map
出会い|meeting, rendezvous, encounter
予防|prevention, protection (against), precaution
飛行|flight, flying, aviation
集まり|gathering, meeting, assembly, collection, attendance
地|earth, ground, land, soil
組|class (of students)
陸|land, shore
孫|grandchild
係|charge, duty, person in charge, official, clerk
輪|ring, circle, loop
年中|whole year, all year round, throughout the year
騒ぎ|uproar, disturbance
盛り|height (e.g. of summer), peak (e.g. of cherry blossom season), (in) season, full bloom, full swing (of a party, etc.)
方々|people, (all) persons, everyone, ladies and gentlemen
問い|question, query
違反|violation, offense, offence, breach, transgression, infringement, contravention
心理|state of mind, mentality, psychology
負け|defeat, loss, losing (a game)
通信|correspondence, communication, transmission, news, signal, telecommunications
勢い|force, vigor, vigour, energy, spirit, life
順|order, turn, sorting
中学|junior high school, middle school, lower secondary school
事務|office work, clerical work, administration, business, affairs
野|plain, field
宿|lodging, inn, hotel
稲|rice plant (Oryza sativa)
金曜|Friday
通行|passage (of people or vehicles), passing (through), traffic
日常|everyday, daily, ordinary, usual, routine, regular
天然|nature, spontaneity
移す|to transfer (to a different place, group, etc.), to change, to swap, to substitute
始まり|origin, beginning, start
候補|candidate, contender, prospect, pick, choice, list
気味|sensation, feeling
予報|forecast, prediction
徹底|thoroughness, completeness, consistency
近代|present day, modern times, recent times
沖|open sea
空き|space, room, gap, emptiness
互い|each other, one another
自動|automatic
注|annotation, explanatory note, comment
名人|master, expert
連れ|companion, company
機関|engine
機嫌|humour, humor, temper, mood, spirits
境|border, boundary
恩|favour, favor, obligation, debt of gratitude
木曜|Thursday
題|title, subject, theme, topic
典型|type, pattern, model, epitome, exemplar, archetype, perfect example
縄|rope, cord
中古|used, second-hand, old
学|learning, scholarship, study, erudition, knowledge, education
可|acceptable, satisfactory, allowed, permitted
誠に|indeed, really, absolutely, truly, actually, very, quite
束|bundle, bunch, sheaf
嫁|bride
見当|estimate, guess, conjecture, aim
定期|fixed period, fixed term
加減|degree, extent, amount, balance, state, condition
作法|manners, etiquette, propriety
参考|reference, consultation
高速|high-speed, rapid, express
泉|spring, fountain
祝い|congratulation, congratulations, celebration, festival
図書|books
宅|house, home
段|step, stair, rung, (flight of) steps
火曜|Tuesday
同時|simultaneous, concurrent, same time, synchronous, together
不可|wrong, bad, improper, unjustifiable, inadvisable
現れ|embodiment, manifestation, materialization, materialisation, expression, indication
局|bureau, department
大戦|great war, great battle
今に|before long, even now
勘|perception, intuition, the sixth sense
消防|fire fighting
下り|down-train, train heading toward the ending point of its route
老い|old age, old person, the old, the aged
仕舞う|to finish, to stop, to end, to put an end to, to bring to a close
様|appearing ..., looking ...
貰う|to receive, to take, to accept
全て|everything, all, the whole
全く|really, truly, entirely, completely, wholly, perfectly
履く|to put on (lower-body clothing, e.g. pants, skirt, footwear), to wear
信じる|to believe, to believe in, to place trust in, to confide in, to have faith in
与える|to give (esp. to someone of lower status), to bestow, to grant, to confer, to present, to award
分|part, portion, share
頃|(approximate) time, around, about, toward
知らせ|news, word, tidings, notice, notification, information
求める|to want, to wish for
得る|to get, to earn, to acquire, to procure, to gain, to secure, to attain, to obtain, to win
者|person
嬉しい|happy, glad, pleased, delighted, overjoyed
可也|considerably, fairly, quite, rather, pretty
学ぶ|to learn, to study, to take lessons in
過ごす|to spend (time), to pass, to lead (a life), to live
位|"throne, crown, (nobleman's) seat"
認める|to recognize, to recognise, to observe, to notice
気付く|to notice, to realize, to realise, to become aware (of), to perceive, to sense, to suspect
頂く|to receive, to get, to accept, to take, to buy
遂に|finally, at last
先ず|first (of all), firstly, to begin with, before anything else
有らゆる|all, every
宜しい|good, OK, all right, fine, very well, will do, may, can
暮らす|to live, to get along
丸で|quite, entirely, completely, at all
数|several, a number of
気に入る|"to like, to be pleased with, to be delighted with, to take a liking to, to suit one's fancy"
如何しても|by all means, at any cost, no matter what, at any rate, surely
解く|to untie, to unfasten, to unwrap, to undo, to unbind, to unpack
喋る|to talk, to chat, to chatter
優れる|to surpass, to outstrip, to excel
寧ろ|rather, better, instead, if anything
何時でも|always, all the time, at all times
遅刻|lateness, tardiness, arriving late
従う|to obey (an order, law, etc.), to abide by (a rule, custom, etc.), to follow, to observe, to conform to, to yield to
例え|example
怪我|injury, wound
回り|rotation
益々|increasingly, more and more, decreasingly (when declining), less and less
済みません|"excuse me, pardon me, I'm sorry, I beg your pardon"
現す|to represent, to signify, to stand for
描く|to draw, to paint, to sketch
少しも|(not) at all, (not) a bit, (not) in the least, (not) in the slightest
丸|circle
述べる|to state, to express, to say, to tell, to mention
当たる|to be hit, to strike
切れる|to break, to snap, to be cut, to split, to crack
会|meeting, assembly, party, gathering, conference, athletic meet
或|a certain ..., some ...
向ける|to turn (towards), to face, to point, to aim, to direct to
効く|to be effective, to take effect, to be good (for)
中中|very, considerably, easily, readily, fairly, quite, highly, rather
約|approximately, about
僅か|a little, a few, small, slight, trifling, meagre, meager, narrow (margin)
避ける|to avoid (physical contact with)
賢い|wise, clever, smart
正に|exactly, just, precisely, really, truly, surely, certainly, without doubt
経つ|to pass (of time), to elapse
勿論|of course, certainly, naturally
夢中|absorbed in, immersed in, crazy about, obsessed with, devoted to
諦める|to give up, to abandon (hope, plans), to resign oneself (to)
掴む|"to seize, to catch, to grasp, to grip, to grab, to clutch, to hold, to catch hold of, to lay one's hands on"
床|floor
随分|very, extremely, surprisingly, fairly, quite, considerably, awfully, terribly
伸ばす|to grow long (e.g. hair, nails)
異なる|to differ, to be different, to disagree, to vary, to diverge
飼う|to keep (a pet or other animal), to have, to own, to raise, to rear, to feed
去る|to leave, to go away
沈む|to sink, to go under, to submerge
輝く|to shine, to sparkle, to twinkle, to glitter, to glisten
願う|to desire, to wish, to hope
利口|clever, intelligent, bright, smart, wise, sensible, shrewd
取れる|to come off (of a button, handle, lid, etc.)
似合う|to suit, to match, to become, to be like
叩く|"to strike, to hit, to beat, to knock, to pound, to bang, to slap, to spank, to tap, to pat, to clap (one's hands), to play (the drums)"
偶々|by chance, by accident, accidentally, happen to (be, do), unexpectedly, casually
匂い|odour, odor, scent, smell, stench
お喋り|chattering, talk, idle talk, chat, chitchat, gossip
招く|to invite, to ask
任せる|to leave (a matter, decision, etc. to someone), to entrust (to someone), to entrust (someone) with
割る|to divide
凝乎と|motionlessly (e.g. stand, wait), (be) still
触れる|to touch, to feel
所謂|what is called, as it is called, the so-called, so to speak
届く|to reach, to touch, to get to, to carry (of sound)
解ける|to be solved, to be resolved
文|sentence
不平|discontent, dissatisfaction, complaint, grievance
立ち上がる|to stand up, to get up
大した|considerable, great, important, significant, a big deal
腐る|to rot, to go bad, to decay, to spoil, to fester, to decompose, to turn sour (e.g. milk)
宜しく|well, properly, suitably
伺う|to call on someone, to call at a place, to pay a visit, to wait on someone
軈て|before long, soon, shortly
通じる|to be open (to traffic), to lead to, to communicate (with)
稼ぐ|to earn (income), to make (money)
罹る|to contract (a disease), to suffer from
含む|to contain, to comprise, to have, to hold, to include, to embrace
辞める|"to resign, to retire, to quit, to leave (one's job, etc.)"
微笑む|to smile
苦しむ|to suffer, to groan, to be worried
種|seed (e.g. of a plant), pip, kernel, stone (e.g. of a peach)
近頃|lately, recently, nowadays
詰まり|that is to say, that is, in other words, I mean, that (this, it) means
叱る|to scold, to chide, to rebuke, to reprimand
勧める|to recommend (someone to do), to advise, to encourage, to urge
兎に角|anyway, anyhow, at any rate, in any case, at least, just
基づく|to be based (on), to be founded (on), to be grounded (on), to be in accordance (with)
済ませる|to finish, to make an end of, to get through with, to let end
責める|to condemn, to blame, to criticize, to criticise, to reproach, to accuse
苛々|to get irritated, to get annoyed, to be on the edge, to fret, to lose patience
案|idea, plan, proposal, suggestion, (government) bill
面|face
就く|to take (seat, position, course, office, etc.), to assume, to be hired, to be employed
捕まる|to be caught, to be arrested
欠ける|to chip, to be chipped, to break (off), to be damaged
向く|to turn toward, to look (up, down, etc.)
従兄弟|cousin (male)
精々|at the most, at best
横切る|to cross (e.g. road), to traverse
転ぶ|to fall down, to fall over
強調|emphasis, stress, highlighting, underlining, underscoring
下ろす|to take down, to bring down, to lower (a hand, flag, shutter, etc.), to drop (an anchor, curtain, etc.), to let down (hair), to launch (a boat)
生まれ|birth, birthplace
生じる|to produce, to yield, to cause
轢く|to run over (with a vehicle), to knock down
其の儘|without change, as is
法|law, act, principle
隠れる|to hide, to conceal oneself, to take cover
劣る|to be inferior to, to be less good at, to fall behind
吠える|to bark, to howl, to bay, to roar, to yelp, to yap
訴える|"to raise, to bring to (someone's attention)"
繋ぐ|to connect, to link together
怠ける|to be lazy, to be idle, to slack
震える|to shiver, to shake, to quake, to tremble, to quaver, to quiver
伸びる|to stretch, to extend, to lengthen, to grow (of hair, height, grass, etc.)
広がる|to spread (out), to extend, to stretch, to reach to, to get around, to fill (e.g. a space)
凍る|to freeze, to become frozen, to freeze over
悪戯|mischief, prank, trick, practical joke
罰する|to punish, to penalize, to penalise
堪らない|intolerable, unbearable, unendurable
濃い|deep (colour), dark
酔う|to get drunk, to become intoxicated
態と|on purpose, deliberately, intentionally
飽きる|to get tired of, to tire of, to lose interest in, to grow weary of, to get fed up with, to get sick of, to become bored with
生憎|unfortunately, sorry, but ...
支える|to support, to prop, to sustain, to underlay, to hold up, to defend
除く|to remove, to eliminate, to eradicate
論じる|to discuss, to talk about, to deal with (a topic)
抜く|to pull out, to draw out, to extract, to unplug, to weed
満ちる|to fill, to become full (of), to be filled (with), to brim (with)
直に|directly, in person, firsthand
適する|to fit, to suit
真面目|serious, earnest, sober, grave
何時までも|forever, eternally, for good, as long as one likes, indefinitely, endlessly, for a long time
若しも|if, in case, supposing
陰|shade, shadow
臭い|stinking, smelly
振る|to wave, to shake, to swing
途端|just (now, at the moment, etc.), just as, in the act of, as soon as, at the moment that
通り過ぎる|to go past, to pass, to pass by
幼い|very young, little
止す|to stop (doing), to cease, to desist, to drop, to lay off, to give up, to quit
喉|throat
真似|imitating, copying, mimicry
行儀|manners, behavior, behaviour
性|nature (of a person)
不図|suddenly, casually, accidentally, incidentally, unexpectedly, unintentionally
凡そ|about, roughly, approximately
抜ける|to come out, to fall out, to be omitted, to be missing, to escape, to come loose
用心|care, precaution, guarding, caution
物音|noise, sound
防ぐ|to defend against, to protect against
熱中|being enthusiastic about, being wild about, being absorbed in, being engrossed in, being devoted to
等しい|equal, identical, the same
諺|proverb, saying, aphorism, maxim
譲る|to hand over, to transfer, to turn over, to assign, to convey, to bequeath
放す|to release, to let go, to free, to set free, to let loose, to turn loose
省く|to omit, to leave out, to exclude, to eliminate
上達|improvement (e.g. in skill, ability), advance, progress
眺め|scene, view, prospect, outlook
取り上げる|to pick up
逆らう|to go against, to oppose, to disobey, to defy
気の毒|pitiful, unfortunate, poor, miserable, wretched
増す|to increase, to grow
占める|to occupy, to hold
申し込む|to apply for, to make an application, to propose (marriage), to offer (mediation), to make an overture (of peace), to challenge, to lodge (objections), to request (an interview), to subscribe for, to book, to reserve
詰める|to stuff into, to jam, to cram, to pack, to fill, to plug, to stop up
可愛らしい|lovely, sweet, pretty, cute, adorable
即ち|that is (to say), namely, i.e.
一人一人|each (person), individually, one by one, one at a time, in turn
一度に|all at once
我が儘|selfish, egoist
その内|before very long, soon, someday, one of these days, sooner or later
狂う|"to go mad, to lose one's mind, to go crazy, to go insane"
頂戴|receiving, getting, accepting, being given
札|banknote, bill, note, paper money
売れる|to sell (well)
生|raw, uncooked, fresh
真剣|serious, earnest
迷子|lost child, lost person, stray child, missing child
象|elephant (Elephantidae spp.)
頻りに|frequently, repeatedly, often, incessantly, constantly
飛ばす|to let fly, to make fly, to send flying, to blow off (e.g. in the wind), to launch, to fire, to hurl, to shoot
要点|gist, main point
食う|to eat
指す|to point
至る|to arrive at (e.g. a decision), to reach (a stage), to attain
贅沢|luxury, extravagance
発車|departure (of a train, car, etc.), starting, leaving
最中|(in) the middle of, (in) the midst of, (in) the course of, (at) the height of
居眠り|nodding off (while sitting), dozing
真逆|"by no means, never!, well, I never!, you don't say!, certainly (not)"
停留所|stop (bus, tram, etc.), station, stopping place
反抗|opposition, resistance, insubordination, defiance, hostility, rebellion
余分|extra, excess, surplus
親戚|relative, relation, kin
進める|to advance, to move forward, to put (a clock, watch) forward
上等|superior, first-class, excellent, top quality
今にも|at any moment (now), at any minute, on the verge of (doing), just about to
離す|to separate, to part, to divide, to keep apart
越す|to cross over (e.g. mountain), to go across
平ら|flat, level, even, smooth
包み|bundle, package, parcel
手品|magic (illusion), conjuring, magic trick, conjuring trick, sleight of hand
覚める|to wake, to wake up
率|rate, ratio, proportion, percentage
積もる|to pile up, to accumulate
綿|cotton
及ぼす|to exert (influence), to exercise, to cause (e.g. damage), to do (e.g. harm), to bring about (e.g. benefits), to extend, to have an effect (on)
咳|cough, coughing, tussis
旧|old, former, ex-
稍|a little, partially, somewhat, slightly, semi-, -ish, on the ... side, a short time, a while
切れ|piece, slice, strip, scrap
器用|skillful, skilful, adroit, dexterous, dextrous, deft, nimble, handy
唸る|to groan, to moan
説|theory, doctrine
粗い|coarse, rough
大屋|landlord, landlady
節|joint, knuckle
覚ます|to awaken, to arouse from sleep
関する|to concern, to be related
銅貨|copper coin
違いない|sure, no mistaking it, for certain, without doubt
原|field, plain, prairie, tundra, moor, wilderness
仕舞った|darn it!, darn!, oops!, oh dear!, oh no!
頂きます|thank you (for the meal just served), I receive (this meal)
矢張り|as expected, sure enough, just as one thought
これ等|these
旨い|skillful, skilful, skilled, good, expert, clever (expression, trick, etc.), apt, appropriate
急に|swiftly, rapidly, quickly, immediately, hastily, hurriedly
番|number (in a series)
人ごみ|crowd of people
持ち上げる|to elevate, to raise, to lift up
お昼|lunch
小|smallness, small item
男の人|man
だって|after all, because
ビール|beer
メンバー|member, participant, attendee, lineup (sport)
ドラマ|(non-documentary) television series, TV drama, teledrama, play
オーバー|overcoat
語|word
市場|(town) market, (street) market, marketplace
煙|smoke, fumes
値|price, cost
善|good, goodness, right, virtue
灯|light, lamp
管|pipe, tube
チーム|team
ドレス|dress
スキー|skiing
ボール|ball
ピクニック|picnic
ゲーム|game
ワイン|wine
スープ|(Western) soup
ボート|boat, rowing boat
クリスマス|Christmas
グループ|group (usu. of people)
エンジン|engine
まあ|"just (e.g. ""just wait here""), come now, now, now"
エネルギー|energy
ダンス|dance, dancing
サービス|service, help, assistance, care, concern
ソファ|sofa, couch
度|time (three times, each time, etc.), times
ベンチ|bench
バイオリン|violin
デート|date (with someone), (social) outing (for two), date night
チャンス|chance, opportunity
トランプ|(Western) playing cards
ユーモア|humor, humour, joke
チーズ|cheese
インク|ink
パスポート|passport
スケート|skating (esp. ice), skate, skates
ドライブ|drive, trip by car, driving
ノック|knock, knocking
パーセント|percent, per cent, percentage
トンネル|tunnel
キャンプ|camp, camping
ヨット|yacht (esp. a sailing boat with one mast), sailing boat, sailboat
ハイキング|hiking
パイロット|pilot
スタイル|"(one's) figure, build, physique, shape"
アルバム|album
ラケット|racket, paddle (in table-tennis)
ウィスキー|whisky, whiskey
タイプライター|typewriter
タオル|towel
アイスクリーム|ice cream, icecream
ロケット|rocket
テント|tent
ジェット機|jet aeroplane, jet airplane
ブレーキ|brake
パイプ|pipe, tube
コーチ|coach
ベルト|belt (waist, seat, etc.), strap
霜|frost
ケース|case (container)
ジュース|juice
アイロン|iron (for pressing clothes)
アウト|out (of a ball; in tennis, etc.), outside the line
スタンド|stands, bleachers
プラス|plus, addition
日本|Japan
オフィス|office
キャプテン|captain
ジーンズ|jeans
マスター|to master (a skill)
パス|passing (a test, examination, etc.)
カー|car
日中|daytime, during the day
セット|set (of things), combo
センター|centre, center
マーケット|market
何でも|any, anything, whatever, whatever one likes, everything, all
名|name, given name
何とか|something, something or other, so-and-so
何時か|sometime, someday, one day, some time or other, the other day, in due course, in time
楽|comfort, ease, relief, (at) peace, relaxation
行き|the way there, outbound leg, outbound trip, departing leg
流行|fashion, trend, vogue, craze, fad, popularity
故郷|"hometown, birthplace, native place, one's old home"
台|stand, rest, base, pedestal, platform, table, holder, support, rack
悪口|slander, bad-mouthing, abuse, insult, speaking ill (of)
お互い|each other, one another
世間|world, society, people, the public
預ける|"to leave (in someone's keeping), to put (in someone's care), to place (in someone's custody), to entrust (someone) with, to deposit"
主に|mainly, primarily, mostly, largely, chiefly
一種|a kind, a sort, a variety, a species
逆|reverse, opposite
税|tax
末|end, tip, top
同一|identical, same, one and the same, equal
章|chapter, section
土|earth, soil, dirt, clay, mud
縁|rim, brim, edge, brink
無|nothing, naught, nought, nil, zero
人工|artificial, man-made, human work, human skill, artificiality
柄|pattern, design
密|dense, thick, crowded
堀|moat, fosse
曜日|day of the week
松|pine tree (Pinus spp.)
はあ|yes, indeed, well
金|gold (metal)
かも知れない|may, might, perhaps, may be, possibly
ずっと|continuously, the whole time, all the way, throughout
どんな|what kind of, what sort of, what
実|fruit, nut
どんなに|how, how much, to what extent
何処か|somewhere
其処で|so, accordingly, now, then, thereupon, therefore
有り難う|thank you, thanks
滅多に|rarely, seldom
ミルク|milk
こんなに|so, like this, in this way
夫れ夫れ|each, respectively
被る|"to put on (one's head), to wear, to have on, to pull over (one's head), to crown (oneself)"
其れ共|or, or else
がっかり|to be disappointed, to be dejected, to be downhearted, to be discouraged, to be disheartened, to lose heart, to feel let down
彼方此方|here and there, various places, all around, all over, everywhere, throughout
きちんと|properly, accurately, exactly, precisely, regularly
スピーチ|speech
所為|consequence, outcome, result, blame, fault
ですから|so, therefore, accordingly, consequently, on those grounds, that is why, for that reason
バッグ|bag
其れでも|but (still), and yet, nevertheless, even so, notwithstanding
品|article, item, thing, goods, stock
ペンキ|paint
溺れる|to struggle in the water, to sink below the surface and become unable to breathe, to (nearly) drown
ちゃんと|diligently, seriously, earnestly, reliably, steadily, legitimately
たった|only, merely, but, no more than
きつい|tough, hard, severe, demanding, harsh
ぐっすり|soundly (sleeping), fast (asleep)
ぴったり|tightly, closely
何故なら|because, the reason is, if you want to know why
塵|rubbish, trash, garbage, refuse, litter
さっぱり|feeling refreshed, feeling relieved
然も|moreover, furthermore
所で|by the way, incidentally
偖|well, now, then
対|pair, couple, set
メモ|note, memo, memorandum
ハンサム|handsome
ざっと|roughly, approximately, round about, more or less
スイッチ|switch
たっぷり|plentifully, amply, abundantly, copiously, generously, fully, a lot
ダイヤ|diamond
ぼんやり|dimly, faintly, indistinctly, vaguely
今日は|hello, good day, good afternoon
プラン|plan, scheme
のんびり|at leisure, in a relaxed manner, in a carefree manner, quietly, peacefully
プロ|professional, pro
デモ|demonstration, protest
ビデオ|video (esp. a televised image)
トップ|top
鋏|scissors, shears, clippers
クリーム|cream
スター|star (cinema, sports, etc.), celebrity, idol
ボーイ|boy
クラシック|classical music
屯|ton (esp. a metric ton, i.e. 1000 kg), tonne
マイク|mike, mic, microphone
所が|even so, however, still, whereupon, even though, nevertheless, on the contrary, as a matter of fact, despite
空く|to become less crowded, to thin out, to get empty
仏|Buddha, Shakyamuni
田|rice field
そっくり|all, altogether, entirely, completely
いらっしゃい|come, go, stay
にっこり|sweetly (smiling), broadly (grinning)
だけど|however
だが|but, however, (and) yet, nevertheless, still, for all that
ノー|no
身|"one's body, one's person"
閉じる|to close (e.g. book, eyes, meeting, etc.), to shut
叫ぶ|to shout, to cry, to scream, to shriek, to yell, to exclaim
撃つ|to shoot (a gun, person, etc.), to fire
奥|"inner part, interior, back (of a drawer, one's throat, etc.), depths (e.g. of a forest), recesses (e.g. of a cave), heart, end (of a road, garden, etc.)"
申し訳|apology, excuse
訓|native Japanese reading of a Chinese character
正|(logical) true, regular
暮れ|sunset, sundown, nightfall, dusk
具体|concreteness, embodiment
御|honorific/polite/humble prefix
行けない|bad, wrong, naughty
抱く|"to hold in one's arms (e.g. a baby), to embrace, to hug"
尤も|but then, although, though
吐く|to vomit, to throw up, to spit up
とんでも無い|unthinkable, unexpected, absurd, outrageous, preposterous, terrible
或いは|or, either ... or
対する|to face (each other), to be facing
吃驚|to be surprised, to be amazed, to be frightened, to be astonished, to get startled, to jump
あんなに|to that extent, to that degree, so much, so
極|pole
御免なさい|"I'm sorry, my apologies, excuse me, pardon me"
ばったり|with a clash, with a thud, with a bang, with a flop, plump
けち|stinginess, miserliness, penny-pinching, miser, pinchpenny, skinflint, cheapskate, tightwad, niggard
ライター|lighter
グランド|grand, large
ゴール|goal (in soccer, hockey, etc.), basket (in basketball)
バン|bun (hairstyle)
徐々|slow, gradual, steady
球|sphere, globe, ball, bulb
不|un-, non-, negative prefix
率土|ends of the earth, outer reaches, borderland
無し|without
トラック|truck, lorry
カード|card (information, filing, etc.)
サイン|autograph, signature
ミス|mistake, error, blunder
グラス|glass (drinking vessel)
お目出度う|congratulations!, well done!, best wishes!, all the best!
ママ|mom, mommy, mum, mummy, mother, mama, mamma
ホーム|platform
ピン|pin (e.g. hairpin, safety pin)
コード|code, program
直|straight
ト|7th (in a sequence denoted by the iroha system)
現場|actual spot, scene (of a crime, accident, etc.)
波|wave
女王|queen
制度|system, institution, organization, organisation
国家|state, country, nation
化学|chemistry
知恵|wisdom, wit, sagacity, sense, intelligence
感覚|sense, sensation, feeling, intuition
絵画|painting, picture
神経|nerve
営業|business, trade, operations
人種|race (of people)
体育|physical education, PE, gym (class)
年間|(period of) a year
欠点|fault, defect, flaw, weak point, weakness, shortcoming, drawback
延期|postponement, deferment, adjournment
明かり|light, illumination, glow, gleam
食物|food, foodstuff
自身|"(one's) self, oneself"
有能|able, capable, competent, talented, efficient
有効|valid, effective
貴重|precious, valuable
構う|to mind, to care about, to be concerned about, to have a regard for
囲む|to surround, to encircle, to enclose, to fence, to wall in
友|friend, companion, comrade, pal
詳しい|detailed, full, minute
疑問|doubt, question, suspicion, dubiousness
見事|splendid, magnificent, excellent, fine, superb, beautiful, admirable
一家|"a family, a household, a home, one's family, whole family"
要素|component, factor, item (e.g. in list)
意思|intention, wish, purpose, mind (to do)
予測|prediction, estimation
普段|usual, normal, everyday, habitual, ordinary
連続|continuation, succession, series
物理|laws of nature, physical laws
指導|guidance, leadership, instruction, direction, coaching
限界|limit, bound
悲劇|tragedy, tragic drama, tragic play
担当|being in charge (of an area of responsibility), being responsible (for a work role, etc.)
清潔|clean, hygienic, sanitary
修正|amendment, correction, revision, modification, alteration, retouching, update, fix
土曜|Saturday
手間|time, labour, labor
必死|frantic, frenetic, desperate
迷惑|trouble, bother, annoyance, nuisance, inconvenience
大気|atmosphere, air
革|leather
来|next (year, spring, etc.), coming
哀れ|pity, sorrow, grief, misery, compassion, pathos